,state_id,Title,Total,Partial vaccinated,Fully Vaccinated,Date
0,1,Andaman and Nicobar Islands,9634,7260,2374,2021-03-08 18:00:53
1,2,Andhra Pradesh,693146,496820,196326,2021-03-08 18:00:53
2,3,Arunachal Pradesh,39569,29075,10494,2021-03-08 18:00:53
3,4,Assam,391651,330428,61223,2021-03-08 18:00:53
4,5,Bihar,783296,572556,210740,2021-03-08 18:00:53
5,6,Chandigarh,30339,26736,3603,2021-03-08 18:00:53
6,7,Chhattisgarh,561149,427770,133379,2021-03-08 18:00:53
7,8,Dadra and Nagar Haveli,6868,5746,1122,2021-03-08 18:00:53
8,9,Delhi,458286,382337,75949,2021-03-08 18:00:53
9,10,Goa,40444,33101,7343,2021-03-08 18:00:53
10,11,Gujarat,1553759,1188707,365052,2021-03-08 18:00:53
11,12,Haryana,288813,209569,79244,2021-03-08 18:00:53
12,13,Himachal Pradesh,130274,82240,48034,2021-03-08 18:00:53
13,14,Jammu and Kashmir,307649,277230,30419,2021-03-08 18:00:53
14,15,Jharkhand,375657,301736,73921,2021-03-08 18:00:53
15,16,Karnataka,739467,475569,263898,2021-03-08 18:00:53
16,17,Kerala,843983,635264,208719,2021-03-08 18:00:53
17,18,Ladakh,17089,14869,2220,2021-03-08 18:00:53
18,19,Lakshadweep,1533,1345,188,2021-03-08 18:00:53
19,20,Madhya Pradesh,888379,643840,244539,2021-03-08 18:00:53
20,21,Maharashtra,1452422,1168837,283585,2021-03-08 18:00:53
21,22,Manipur,64515,58800,5715,2021-03-08 18:00:53
22,23,Meghalaya,49642,43403,6239,2021-03-08 18:00:53
23,24,Mizoram,35391,26151,9240,2021-03-08 18:00:53
24,25,Nagaland,33606,27726,5880,2021-03-08 18:00:53
25,26,Odisha,643043,451892,191151,2021-03-08 18:00:53
26,27,Puducherry,16588,14136,2452,2021-03-08 18:00:53
27,28,Punjab,227955,178695,49260,2021-03-08 18:00:53
28,29,Rajasthan,1885161,1549564,335597,2021-03-08 18:00:53
29,30,Sikkim,27414,22226,5188,2021-03-08 18:00:53
30,31,Tamil Nadu,653666,579892,73774,2021-03-08 18:00:53
31,32,Telangana,394485,223609,170876,2021-03-08 18:00:53
32,33,Tripura,114962,82583,32379,2021-03-08 18:00:53
33,34,Uttar Pradesh,1623092,1086600,536492,2021-03-08 18:00:53
34,35,Uttarakhand,208722,147239,61483,2021-03-08 18:00:53
35,36,West Bengal,1418378,1159202,259176,2021-03-08 18:00:53
36,37,Daman and Diu,5065,4182,883,2021-03-08 18:00:53
37,1,Andaman and Nicobar Islands,9932,7542,2390,2021-03-09 18:01:28
38,2,Andhra Pradesh,738119,528266,209853,2021-03-09 18:01:28
39,3,Arunachal Pradesh,41504,30634,10870,2021-03-09 18:01:28
40,4,Assam,422721,354343,68378,2021-03-09 18:01:28
41,5,Bihar,882429,649652,232777,2021-03-09 18:01:28
42,6,Chandigarh,32656,28543,4113,2021-03-09 18:01:28
43,7,Chhattisgarh,600054,455510,144544,2021-03-09 18:01:28
44,8,Dadra and Nagar Haveli,7329,5965,1364,2021-03-09 18:01:28
45,9,Delhi,479756,395059,84697,2021-03-09 18:01:28
46,10,Goa,43934,36021,7913,2021-03-09 18:01:28
47,11,Gujarat,1708482,1302425,406057,2021-03-09 18:01:28
48,12,Haryana,317555,229730,87825,2021-03-09 18:01:28
49,13,Himachal Pradesh,144569,93447,51122,2021-03-09 18:01:28
50,14,Jammu and Kashmir,333953,296863,37090,2021-03-09 18:01:28
51,15,Jharkhand,401760,313492,88268,2021-03-09 18:01:28
52,16,Karnataka,788237,511188,277049,2021-03-09 18:01:28
53,17,Kerala,917287,689421,227866,2021-03-09 18:01:28
54,18,Ladakh,19663,17371,2292,2021-03-09 18:01:28
55,19,Lakshadweep,1667,1452,215,2021-03-09 18:01:28
56,20,Madhya Pradesh,894170,648490,245680,2021-03-09 18:01:28
57,21,Maharashtra,1568662,1263337,305325,2021-03-09 18:01:28
58,22,Manipur,66537,60426,6111,2021-03-09 18:01:28
59,23,Meghalaya,52453,45314,7139,2021-03-09 18:01:28
60,24,Mizoram,37650,28292,9358,2021-03-09 18:01:28
61,25,Nagaland,35005,28779,6226,2021-03-09 18:01:28
62,26,Odisha,705701,493150,212551,2021-03-09 18:01:28
63,27,Puducherry,17897,15136,2761,2021-03-09 18:01:28
64,28,Punjab,246481,193506,52975,2021-03-09 18:01:28
65,29,Rajasthan,1958224,1603029,355195,2021-03-09 18:01:28
66,30,Sikkim,30526,24586,5940,2021-03-09 18:01:28
67,31,Tamil Nadu,732460,650520,81940,2021-03-09 18:01:28
68,32,Telangana,424230,241322,182908,2021-03-09 18:01:28
69,33,Tripura,123820,87219,36601,2021-03-09 18:01:28
70,34,Uttar Pradesh,1707149,1168813,538336,2021-03-09 18:01:28
71,35,Uttarakhand,228213,160878,67335,2021-03-09 18:01:28
72,36,West Bengal,1581634,1298432,283202,2021-03-09 18:01:28
73,37,Daman and Diu,5249,4347,902,2021-03-09 18:01:28
74,1,Andaman and Nicobar Islands,10161,7735,2426,2021-03-10 17:30:10
75,2,Andhra Pradesh,779747,560697,219050,2021-03-10 17:30:10
76,3,Arunachal Pradesh,41675,30769,10906,2021-03-10 17:30:10
77,4,Assam,440893,368754,72139,2021-03-10 17:30:10
78,5,Bihar,944409,694637,249772,2021-03-10 17:30:10
79,6,Chandigarh,35167,30560,4607,2021-03-10 17:30:10
80,7,Chhattisgarh,648553,489129,159424,2021-03-10 17:30:10
81,8,Dadra and Nagar Haveli,7777,6136,1641,2021-03-10 17:30:10
82,9,Delhi,498456,405286,93170,2021-03-10 17:30:10
83,10,Goa,47240,38480,8760,2021-03-10 17:30:10
84,11,Gujarat,1762840,1332129,430711,2021-03-10 17:30:10
85,12,Haryana,330710,239057,91653,2021-03-10 17:30:10
86,13,Himachal Pradesh,155805,101307,54498,2021-03-10 17:30:10
87,14,Jammu and Kashmir,336587,299203,37384,2021-03-10 17:30:10
88,15,Jharkhand,432167,328055,104112,2021-03-10 17:30:10
89,16,Karnataka,877753,580495,297258,2021-03-10 17:30:10
90,17,Kerala,954553,714209,240344,2021-03-10 17:30:10
91,18,Ladakh,22917,20419,2498,2021-03-10 17:30:10
92,19,Lakshadweep,1854,1535,319,2021-03-10 17:30:10
93,20,Madhya Pradesh,979908,703594,276314,2021-03-10 17:30:10
94,21,Maharashtra,1737955,1400984,336971,2021-03-10 17:30:10
95,22,Manipur,68967,61597,7370,2021-03-10 17:30:10
96,23,Meghalaya,54947,46973,7974,2021-03-10 17:30:10
97,24,Mizoram,41886,32113,9773,2021-03-10 17:30:10
98,25,Nagaland,37176,30252,6924,2021-03-10 17:30:10
99,26,Odisha,750609,521805,228804,2021-03-10 17:30:10
100,27,Puducherry,19605,16600,3005,2021-03-10 17:30:10
101,28,Punjab,262926,206746,56180,2021-03-10 17:30:10
102,29,Rajasthan,2078824,1682824,396000,2021-03-10 17:30:10
103,30,Sikkim,33728,27219,6509,2021-03-10 17:30:10
104,31,Tamil Nadu,819060,728406,90654,2021-03-10 17:30:10
105,32,Telangana,447681,256004,191677,2021-03-10 17:30:10
106,33,Tripura,125805,87999,37806,2021-03-10 17:30:10
107,34,Uttar Pradesh,1733341,1194063,539278,2021-03-10 17:30:10
108,35,Uttarakhand,240331,168955,71376,2021-03-10 17:30:10
109,36,West Bengal,1721128,1417046,304082,2021-03-10 17:30:10
110,37,Daman and Diu,5892,4887,1005,2021-03-10 17:30:10
111,1,Andaman and Nicobar Islands,10704,8218,2486,2021-03-11 18:02:11
112,2,Andhra Pradesh,789145,568487,220658,2021-03-11 18:02:11
113,3,Arunachal Pradesh,44468,32906,11562,2021-03-11 18:02:11
114,4,Assam,460926,384883,76043,2021-03-11 18:02:11
115,5,Bihar,951238,700136,251102,2021-03-11 18:02:11
116,6,Chandigarh,35985,31291,4694,2021-03-11 18:02:11
117,7,Chhattisgarh,654257,493314,160943,2021-03-11 18:02:11
118,8,Dadra and Nagar Haveli,7777,6136,1641,2021-03-11 18:02:11
119,9,Delhi,516393,415311,101082,2021-03-11 18:02:11
120,10,Goa,50241,40416,9825,2021-03-11 18:02:11
121,11,Gujarat,1776794,1341506,435288,2021-03-11 18:02:11
122,12,Haryana,339664,245903,93761,2021-03-11 18:02:11
123,13,Himachal Pradesh,157123,102129,54994,2021-03-11 18:02:11
124,14,Jammu and Kashmir,337754,300043,37711,2021-03-11 18:02:11
125,15,Jharkhand,447790,337027,110763,2021-03-11 18:02:11
126,16,Karnataka,895311,593671,301640,2021-03-11 18:02:11
127,17,Kerala,991390,741593,249797,2021-03-11 18:02:11
128,18,Ladakh,25981,23271,2710,2021-03-11 18:02:11
129,19,Lakshadweep,2056,1589,467,2021-03-11 18:02:11
130,20,Madhya Pradesh,983629,704997,278632,2021-03-11 18:02:11
131,21,Maharashtra,1804040,1455318,348722,2021-03-11 18:02:11
132,22,Manipur,70643,62455,8188,2021-03-11 18:02:11
133,23,Meghalaya,58153,49019,9134,2021-03-11 18:02:11
134,24,Mizoram,43830,33883,9947,2021-03-11 18:02:11
135,25,Nagaland,39893,31808,8085,2021-03-11 18:02:11
136,26,Odisha,758859,527341,231518,2021-03-11 18:02:11
137,27,Puducherry,21232,18039,3193,2021-03-11 18:02:11
138,28,Punjab,269417,212562,56855,2021-03-11 18:02:11
139,29,Rajasthan,2089766,1689250,400516,2021-03-11 18:02:11
140,30,Sikkim,37745,30440,7305,2021-03-11 18:02:11
141,31,Tamil Nadu,896925,797555,99370,2021-03-11 18:02:11
142,32,Telangana,451030,258992,192038,2021-03-11 18:02:11
143,33,Tripura,127690,88696,38994,2021-03-11 18:02:11
144,34,Uttar Pradesh,1741241,1201576,539665,2021-03-11 18:02:11
145,35,Uttarakhand,242959,170793,72166,2021-03-11 18:02:11
146,36,West Bengal,1799367,1483726,315641,2021-03-11 18:02:11
147,37,Daman and Diu,5892,4887,1005,2021-03-11 18:02:11
148,1,Andaman and Nicobar Islands,11321,8735,2586,2021-03-12 18:01:04
149,2,Andhra Pradesh,836713,605519,231194,2021-03-12 18:01:04
150,3,Arunachal Pradesh,46763,34659,12104,2021-03-12 18:01:04
151,4,Assam,480215,399574,80641,2021-03-12 18:01:04
152,5,Bihar,1035324,766055,269269,2021-03-12 18:01:04
153,6,Chandigarh,38246,33091,5155,2021-03-12 18:01:04
154,7,Chhattisgarh,699746,523516,176230,2021-03-12 18:01:04
155,8,Dadra and Nagar Haveli,8481,6511,1970,2021-03-12 18:01:04
156,9,Delhi,535790,425063,110727,2021-03-12 18:01:04
157,10,Goa,55578,44297,11281,2021-03-12 18:01:04
158,11,Gujarat,1939543,1459292,480251,2021-03-12 18:01:04
159,12,Haryana,374228,273843,100385,2021-03-12 18:01:04
160,13,Himachal Pradesh,174855,113763,61092,2021-03-12 18:01:04
161,14,Jammu and Kashmir,340719,300849,39870,2021-03-12 18:01:04
162,15,Jharkhand,478240,353250,124990,2021-03-12 18:01:04
163,16,Karnataka,995796,677816,317980,2021-03-12 18:01:04
164,17,Kerala,1073841,804825,269016,2021-03-12 18:01:04
165,18,Ladakh,28496,25696,2800,2021-03-12 18:01:04
166,19,Lakshadweep,2275,1605,670,2021-03-12 18:01:04
167,20,Madhya Pradesh,988814,708706,280108,2021-03-12 18:01:04
168,21,Maharashtra,1991425,1608619,382806,2021-03-12 18:01:04
169,22,Manipur,73372,63713,9659,2021-03-12 18:01:04
170,23,Meghalaya,60267,50138,10129,2021-03-12 18:01:04
171,24,Mizoram,45491,35460,10031,2021-03-12 18:01:04
172,25,Nagaland,40999,32272,8727,2021-03-12 18:01:04
173,26,Odisha,822415,568356,254059,2021-03-12 18:01:04
174,27,Puducherry,22707,19243,3464,2021-03-12 18:01:04
175,28,Punjab,289493,228262,61231,2021-03-12 18:01:04
176,29,Rajasthan,2252698,1824080,428618,2021-03-12 18:01:04
177,30,Sikkim,40751,33168,7583,2021-03-12 18:01:04
178,31,Tamil Nadu,986482,877535,108947,2021-03-12 18:01:04
179,32,Telangana,479057,274591,204466,2021-03-12 18:01:04
180,33,Tripura,137876,93086,44790,2021-03-12 18:01:04
181,34,Uttar Pradesh,1991674,1391469,600205,2021-03-12 18:01:04
182,35,Uttarakhand,266217,185891,80326,2021-03-12 18:01:04
183,36,West Bengal,1968917,1627473,341444,2021-03-12 18:01:04
184,37,Daman and Diu,6291,5237,1054,2021-03-12 18:01:04
185,1,Andaman and Nicobar Islands,11638,8899,2739,2021-03-13 18:01:15
186,2,Andhra Pradesh,880781,643558,237223,2021-03-13 18:01:15
187,3,Arunachal Pradesh,48082,35535,12547,2021-03-13 18:01:15
188,4,Assam,496585,412415,84170,2021-03-13 18:01:15
189,5,Bihar,1151988,861293,290695,2021-03-13 18:01:15
190,6,Chandigarh,40476,34812,5664,2021-03-13 18:01:15
191,7,Chhattisgarh,753546,562201,191345,2021-03-13 18:01:15
192,8,Dadra and Nagar Haveli,8867,6723,2144,2021-03-13 18:01:15
193,9,Delhi,559943,438473,121470,2021-03-13 18:01:15
194,10,Goa,59300,47633,11667,2021-03-13 18:01:15
195,11,Gujarat,2067458,1556573,510885,2021-03-13 18:01:15
196,12,Haryana,390612,287782,102830,2021-03-13 18:01:15
197,13,Himachal Pradesh,181638,118426,63212,2021-03-13 18:01:15
198,14,Jammu and Kashmir,376795,322087,54708,2021-03-13 18:01:15
199,15,Jharkhand,506091,368465,137626,2021-03-13 18:01:15
200,16,Karnataka,1048310,722840,325470,2021-03-13 18:01:15
201,17,Kerala,1122882,842896,279986,2021-03-13 18:01:15
202,18,Ladakh,30962,28070,2892,2021-03-13 18:01:15
203,19,Lakshadweep,2510,1657,853,2021-03-13 18:01:15
204,20,Madhya Pradesh,1128200,795662,332538,2021-03-13 18:01:15
205,21,Maharashtra,2123060,1711588,411472,2021-03-13 18:01:15
206,22,Manipur,74264,64162,10102,2021-03-13 18:01:15
207,23,Meghalaya,61873,50922,10951,2021-03-13 18:01:15
208,24,Mizoram,45897,35797,10100,2021-03-13 18:01:15
209,25,Nagaland,41434,32391,9043,2021-03-13 18:01:15
210,26,Odisha,878668,610148,268520,2021-03-13 18:01:15
211,27,Puducherry,24482,20721,3761,2021-03-13 18:01:15
212,28,Punjab,308163,243504,64659,2021-03-13 18:01:15
213,29,Rajasthan,2438590,1994521,444069,2021-03-13 18:01:15
214,30,Sikkim,41234,33649,7585,2021-03-13 18:01:15
215,31,Tamil Nadu,1082917,963536,119381,2021-03-13 18:01:15
216,32,Telangana,495638,287950,207688,2021-03-13 18:01:15
217,33,Tripura,143379,96147,47232,2021-03-13 18:01:15
218,34,Uttar Pradesh,2077983,1457700,620283,2021-03-13 18:01:15
219,35,Uttarakhand,283584,198074,85510,2021-03-13 18:01:15
220,36,West Bengal,2101575,1739613,361962,2021-03-13 18:01:15
221,37,Daman and Diu,6724,5618,1106,2021-03-13 18:01:15
222,1,Andaman and Nicobar Islands,11693,8926,2767,2021-03-14 18:00:43
223,2,Andhra Pradesh,881921,644610,237311,2021-03-14 18:00:43
224,3,Arunachal Pradesh,48215,35654,12561,2021-03-14 18:00:43
225,4,Assam,497722,413455,84267,2021-03-14 18:00:43
226,5,Bihar,1159608,867885,291723,2021-03-14 18:00:43
227,6,Chandigarh,40701,34965,5736,2021-03-14 18:00:43
228,7,Chhattisgarh,763377,571298,192079,2021-03-14 18:00:43
229,8,Dadra and Nagar Haveli,8871,6727,2144,2021-03-14 18:00:43
230,9,Delhi,560392,438862,121530,2021-03-14 18:00:43
231,10,Goa,59323,47655,11668,2021-03-14 18:00:43
232,11,Gujarat,2083770,1568691,515079,2021-03-14 18:00:43
233,12,Haryana,395200,292010,103190,2021-03-14 18:00:43
234,13,Himachal Pradesh,183330,119938,63392,2021-03-14 18:00:43
235,14,Jammu and Kashmir,379043,323902,55141,2021-03-14 18:00:43
236,15,Jharkhand,524193,380103,144090,2021-03-14 18:00:43
237,16,Karnataka,1067414,740906,326508,2021-03-14 18:00:43
238,17,Kerala,1127842,846849,280993,2021-03-14 18:00:43
239,18,Ladakh,31958,29060,2898,2021-03-14 18:00:43
240,19,Lakshadweep,2541,1659,882,2021-03-14 18:00:43
241,20,Madhya Pradesh,1149691,814751,334940,2021-03-14 18:00:43
242,21,Maharashtra,2132547,1720471,412076,2021-03-14 18:00:43
243,22,Manipur,74287,64185,10102,2021-03-14 18:00:43
244,23,Meghalaya,61893,50935,10958,2021-03-14 18:00:43
245,24,Mizoram,46297,36127,10170,2021-03-14 18:00:43
246,25,Nagaland,41574,32404,9170,2021-03-14 18:00:43
247,26,Odisha,890002,620613,269389,2021-03-14 18:00:43
248,27,Puducherry,24531,20768,3763,2021-03-14 18:00:43
249,28,Punjab,310829,246071,64758,2021-03-14 18:00:43
250,29,Rajasthan,2456146,2011573,444573,2021-03-14 18:00:43
251,30,Sikkim,41351,33766,7585,2021-03-14 18:00:43
252,31,Tamil Nadu,1108075,986954,121121,2021-03-14 18:00:43
253,32,Telangana,498000,290166,207834,2021-03-14 18:00:43
254,33,Tripura,143677,96435,47242,2021-03-14 18:00:43
255,34,Uttar Pradesh,2092937,1472200,620737,2021-03-14 18:00:43
256,35,Uttarakhand,286089,199775,86314,2021-03-14 18:00:43
257,36,West Bengal,2117785,1753725,364060,2021-03-14 18:00:43
258,37,Daman and Diu,6724,5618,1106,2021-03-14 18:00:43
259,1,Andaman and Nicobar Islands,12045,9202,2843,2021-03-15 18:00:55
260,2,Andhra Pradesh,955244,708375,246869,2021-03-15 18:00:55
261,3,Arunachal Pradesh,51377,38084,13293,2021-03-15 18:00:55
262,4,Assam,517735,429304,88431,2021-03-15 18:00:55
263,5,Bihar,1234562,924776,309786,2021-03-15 18:00:55
264,6,Chandigarh,43207,36835,6372,2021-03-15 18:00:55
265,7,Chhattisgarh,831027,623226,207801,2021-03-15 18:00:55
266,8,Dadra and Nagar Haveli,9299,6954,2345,2021-03-15 18:00:55
267,9,Delhi,585649,453532,132117,2021-03-15 18:00:55
268,10,Goa,64629,52380,12249,2021-03-15 18:00:55
269,11,Gujarat,2220349,1681129,539220,2021-03-15 18:00:55
270,12,Haryana,486747,374842,111905,2021-03-15 18:00:55
271,13,Himachal Pradesh,194262,128028,66234,2021-03-15 18:00:55
272,14,Jammu and Kashmir,414348,346144,68204,2021-03-15 18:00:55
273,15,Jharkhand,563156,404892,158264,2021-03-15 18:00:55
274,16,Karnataka,1229513,889932,339581,2021-03-15 18:00:55
275,17,Kerala,1209759,913278,296481,2021-03-15 18:00:55
276,18,Ladakh,33327,30423,2904,2021-03-15 18:00:55
277,19,Lakshadweep,2717,1727,990,2021-03-15 18:00:55
278,20,Madhya Pradesh,1300173,926343,373830,2021-03-15 18:00:55
279,21,Maharashtra,2333006,1889438,443568,2021-03-15 18:00:55
280,22,Manipur,77264,65326,11938,2021-03-15 18:00:55
281,23,Meghalaya,64380,52194,12186,2021-03-15 18:00:55
282,24,Mizoram,47444,36933,10511,2021-03-15 18:00:55
283,25,Nagaland,44454,33851,10603,2021-03-15 18:00:55
284,26,Odisha,968576,682170,286406,2021-03-15 18:00:55
285,27,Puducherry,26694,22703,3991,2021-03-15 18:00:55
286,28,Punjab,334507,265778,68729,2021-03-15 18:00:55
287,29,Rajasthan,2620263,2162427,457836,2021-03-15 18:00:55
288,30,Sikkim,43571,35709,7862,2021-03-15 18:00:55
289,31,Tamil Nadu,1203072,1073648,129424,2021-03-15 18:00:55
290,32,Telangana,527695,315493,212202,2021-03-15 18:00:55
291,33,Tripura,157519,104232,53287,2021-03-15 18:00:55
292,34,Uttar Pradesh,2379960,1715158,664802,2021-03-15 18:00:55
293,35,Uttarakhand,310735,218339,92396,2021-03-15 18:00:55
294,36,West Bengal,2314641,1920977,393664,2021-03-15 18:00:55
295,37,Daman and Diu,7249,6058,1191,2021-03-15 18:00:55
296,1,Andaman and Nicobar Islands,12374,9497,2877,2021-03-16 18:00:46
297,2,Andhra Pradesh,1023938,766142,257796,2021-03-16 18:00:46
298,3,Arunachal Pradesh,53255,39505,13750,2021-03-16 18:00:46
299,4,Assam,536333,444319,92014,2021-03-16 18:00:46
300,5,Bihar,1310157,986340,323817,2021-03-16 18:00:46
301,6,Chandigarh,45287,38340,6947,2021-03-16 18:00:46
302,7,Chhattisgarh,901214,680006,221208,2021-03-16 18:00:46
303,8,Dadra and Nagar Haveli,9575,7158,2417,2021-03-16 18:00:46
304,9,Delhi,610943,467441,143502,2021-03-16 18:00:46
305,10,Goa,70030,57391,12639,2021-03-16 18:00:46
306,11,Gujarat,2366359,1803506,562853,2021-03-16 18:00:46
307,12,Haryana,588119,470419,117700,2021-03-16 18:00:46
308,13,Himachal Pradesh,219841,149612,70229,2021-03-16 18:00:46
309,14,Jammu and Kashmir,450517,369385,81132,2021-03-16 18:00:46
310,15,Jharkhand,601972,431847,170125,2021-03-16 18:00:46
311,16,Karnataka,1341902,991410,350492,2021-03-16 18:00:46
312,17,Kerala,1294853,982902,311951,2021-03-16 18:00:46
313,18,Ladakh,35797,32446,3351,2021-03-16 18:00:46
314,19,Lakshadweep,2911,1803,1108,2021-03-16 18:00:46
315,20,Madhya Pradesh,1324453,947052,377401,2021-03-16 18:00:46
316,21,Maharashtra,2475988,2007670,468318,2021-03-16 18:00:46
317,22,Manipur,79103,65946,13157,2021-03-16 18:00:46
318,23,Meghalaya,68323,54180,14143,2021-03-16 18:00:46
319,24,Mizoram,50041,39413,10628,2021-03-16 18:00:46
320,25,Nagaland,47216,35254,11962,2021-03-16 18:00:46
321,26,Odisha,1076245,779021,297224,2021-03-16 18:00:46
322,27,Puducherry,28665,24439,4226,2021-03-16 18:00:46
323,28,Punjab,360276,287786,72490,2021-03-16 18:00:46
324,29,Rajasthan,2833229,2362643,470586,2021-03-16 18:00:46
325,30,Sikkim,46156,38019,8137,2021-03-16 18:00:46
326,31,Tamil Nadu,1308601,1168041,140560,2021-03-16 18:00:46
327,32,Telangana,549049,334375,214674,2021-03-16 18:00:46
328,33,Tripura,176658,119449,57209,2021-03-16 18:00:46
329,34,Uttar Pradesh,2577411,1852265,725146,2021-03-16 18:00:46
330,35,Uttarakhand,336779,238560,98219,2021-03-16 18:00:46
331,36,West Bengal,2539532,2121890,417642,2021-03-16 18:00:46
332,37,Daman and Diu,7789,6537,1252,2021-03-16 18:00:46
333,1,Andaman and Nicobar Islands,12570,9590,2980,2021-03-17 18:01:03
334,2,Andhra Pradesh,1117925,849594,268331,2021-03-17 18:01:03
335,3,Arunachal Pradesh,50118,36326,13792,2021-03-17 18:01:03
336,4,Assam,521999,427974,94025,2021-03-17 18:01:03
337,5,Bihar,1305893,972143,333750,2021-03-17 18:01:03
338,6,Chandigarh,50173,42764,7409,2021-03-17 18:01:03
339,7,Chhattisgarh,921635,687435,234200,2021-03-17 18:01:03
340,8,Dadra and Nagar Haveli,8830,6327,2503,2021-03-17 18:01:03
341,9,Delhi,737305,584370,152935,2021-03-17 18:01:03
342,10,Goa,72593,59519,13074,2021-03-17 18:01:03
343,11,Gujarat,2353930,1780056,573874,2021-03-17 18:01:03
344,12,Haryana,628429,508020,120409,2021-03-17 18:01:03
345,13,Himachal Pradesh,236637,164397,72240,2021-03-17 18:01:03
346,14,Jammu and Kashmir,424963,343444,81519,2021-03-17 18:01:03
347,15,Jharkhand,571951,391049,180902,2021-03-17 18:01:03
348,16,Karnataka,1654224,1290218,364006,2021-03-17 18:01:03
349,17,Kerala,1696771,1377915,318856,2021-03-17 18:01:03
350,18,Ladakh,36468,32797,3671,2021-03-17 18:01:03
351,19,Lakshadweep,3424,2289,1135,2021-03-17 18:01:03
352,20,Madhya Pradesh,1499886,1088366,411520,2021-03-17 18:01:03
353,21,Maharashtra,3236294,2736844,499450,2021-03-17 18:01:03
354,22,Manipur,73462,58713,14749,2021-03-17 18:01:03
355,23,Meghalaya,64495,48584,15911,2021-03-17 18:01:03
356,24,Mizoram,50789,39977,10812,2021-03-17 18:01:03
357,25,Nagaland,43689,30908,12781,2021-03-17 18:01:03
358,26,Odisha,1076385,772365,304020,2021-03-17 18:01:03
359,27,Puducherry,32265,27790,4475,2021-03-17 18:01:03
360,28,Punjab,391583,316328,75255,2021-03-17 18:01:03
361,29,Rajasthan,3064353,2489908,574445,2021-03-17 18:01:03
362,30,Sikkim,45807,37300,8507,2021-03-17 18:01:03
363,31,Tamil Nadu,1427530,1275868,151662,2021-03-17 18:01:03
364,32,Telangana,630339,414567,215772,2021-03-17 18:01:03
365,33,Tripura,170598,112464,58134,2021-03-17 18:01:03
366,34,Uttar Pradesh,2725075,1984162,740913,2021-03-17 18:01:03
367,35,Uttarakhand,358484,256613,101871,2021-03-17 18:01:03
368,36,West Bengal,2694755,2261131,433624,2021-03-17 18:01:03
369,37,Daman and Diu,8435,7046,1389,2021-03-17 18:01:03
370,1,Andaman and Nicobar Islands,13189,10007,3182,2021-03-18 18:00:06
371,2,Andhra Pradesh,1205961,928351,277610,2021-03-18 18:00:06
372,3,Arunachal Pradesh,53355,38624,14731,2021-03-18 18:00:06
373,4,Assam,541484,443358,98126,2021-03-18 18:00:06
374,5,Bihar,1378580,1033329,345251,2021-03-18 18:00:06
375,6,Chandigarh,52173,44311,7862,2021-03-18 18:00:06
376,7,Chhattisgarh,1003806,757694,246112,2021-03-18 18:00:06
377,8,Dadra and Nagar Haveli,9204,6576,2628,2021-03-18 18:00:06
378,9,Delhi,777230,610611,166619,2021-03-18 18:00:06
379,10,Goa,75176,61906,13270,2021-03-18 18:00:06
380,11,Gujarat,2493705,1904676,589029,2021-03-18 18:00:06
381,12,Haryana,685703,561730,123973,2021-03-18 18:00:06
382,13,Himachal Pradesh,250094,175686,74408,2021-03-18 18:00:06
383,14,Jammu and Kashmir,460588,367225,93363,2021-03-18 18:00:06
384,15,Jharkhand,602323,412463,189860,2021-03-18 18:00:06
385,16,Karnataka,1763431,1391043,372388,2021-03-18 18:00:06
386,17,Kerala,1845882,1512684,333198,2021-03-18 18:00:06
387,18,Ladakh,38105,33885,4220,2021-03-18 18:00:06
388,19,Lakshadweep,3633,2346,1287,2021-03-18 18:00:06
389,20,Madhya Pradesh,1650814,1219073,431741,2021-03-18 18:00:06
390,21,Maharashtra,3438852,2914117,524735,2021-03-18 18:00:06
391,22,Manipur,75295,59248,16047,2021-03-18 18:00:06
392,23,Meghalaya,68461,50331,18130,2021-03-18 18:00:06
393,24,Mizoram,51633,40344,11289,2021-03-18 18:00:06
394,25,Nagaland,45739,31982,13757,2021-03-18 18:00:06
395,26,Odisha,1164753,854306,310447,2021-03-18 18:00:06
396,27,Puducherry,35013,30195,4818,2021-03-18 18:00:06
397,28,Punjab,420501,342134,78367,2021-03-18 18:00:06
398,29,Rajasthan,3168302,2576239,592063,2021-03-18 18:00:06
399,30,Sikkim,48047,39029,9018,2021-03-18 18:00:06
400,31,Tamil Nadu,1535330,1373644,161686,2021-03-18 18:00:06
401,32,Telangana,662501,445397,217104,2021-03-18 18:00:06
402,33,Tripura,191196,129948,61248,2021-03-18 18:00:06
403,34,Uttar Pradesh,3101179,2257323,843856,2021-03-18 18:00:06
404,35,Uttarakhand,388781,282182,106599,2021-03-18 18:00:06
405,36,West Bengal,2831476,2380076,451400,2021-03-18 18:00:06
406,37,Daman and Diu,8722,7233,1489,2021-03-18 18:00:06
407,1,Andaman and Nicobar Islands,13678,10359,3319,2021-03-19 18:01:02
408,2,Andhra Pradesh,1299814,1011645,288169,2021-03-19 18:01:02
409,3,Arunachal Pradesh,55874,40318,15556,2021-03-19 18:01:02
410,4,Assam,561014,457424,103590,2021-03-19 18:01:02
411,5,Bihar,1449563,1094690,354873,2021-03-19 18:01:02
412,6,Chandigarh,54240,45977,8263,2021-03-19 18:01:02
413,7,Chhattisgarh,1069004,812104,256900,2021-03-19 18:01:02
414,8,Dadra and Nagar Haveli,9663,6811,2852,2021-03-19 18:01:02
415,9,Delhi,806717,629052,177665,2021-03-19 18:01:02
416,10,Goa,78357,64554,13803,2021-03-19 18:01:02
417,11,Gujarat,2702022,2099219,602803,2021-03-19 18:01:02
418,12,Haryana,755160,627690,127470,2021-03-19 18:01:02
419,13,Himachal Pradesh,284064,206740,77324,2021-03-19 18:01:02
420,14,Jammu and Kashmir,483075,381921,101154,2021-03-19 18:01:02
421,15,Jharkhand,635325,437302,198023,2021-03-19 18:01:02
422,16,Karnataka,2002854,1618797,384057,2021-03-19 18:01:02
423,17,Kerala,1979417,1636524,342893,2021-03-19 18:01:02
424,18,Ladakh,39488,34739,4749,2021-03-19 18:01:02
425,19,Lakshadweep,3752,2399,1353,2021-03-19 18:01:02
426,20,Madhya Pradesh,1687525,1254183,433342,2021-03-19 18:01:02
427,21,Maharashtra,3680896,3125024,555872,2021-03-19 18:01:02
428,22,Manipur,77719,59886,17833,2021-03-19 18:01:02
429,23,Meghalaya,72152,51917,20235,2021-03-19 18:01:02
430,24,Mizoram,52424,40580,11844,2021-03-19 18:01:02
431,25,Nagaland,47302,32864,14438,2021-03-19 18:01:02
432,26,Odisha,1257840,940957,316883,2021-03-19 18:01:02
433,27,Puducherry,37441,32217,5224,2021-03-19 18:01:02
434,28,Punjab,453844,372213,81631,2021-03-19 18:01:02
435,29,Rajasthan,3364253,2743813,620440,2021-03-19 18:01:02
436,30,Sikkim,51105,41591,9514,2021-03-19 18:01:02
437,31,Tamil Nadu,1647268,1474581,172687,2021-03-19 18:01:02
438,32,Telangana,690649,472409,218240,2021-03-19 18:01:02
439,33,Tripura,223713,159616,64097,2021-03-19 18:01:02
440,34,Uttar Pradesh,3444547,2562662,881885,2021-03-19 18:01:02
441,35,Uttarakhand,421910,311377,110533,2021-03-19 18:01:02
442,36,West Bengal,3114684,2640012,474672,2021-03-19 18:01:02
443,37,Daman and Diu,9452,7896,1556,2021-03-19 18:01:02
444,1,Andaman and Nicobar Islands,14420,10841,3579,2021-03-20 18:01:17
445,2,Andhra Pradesh,1403674,1104716,298958,2021-03-20 18:01:17
446,3,Arunachal Pradesh,57868,41804,16064,2021-03-20 18:01:17
447,4,Assam,577869,469242,108627,2021-03-20 18:01:17
448,5,Bihar,1527253,1162335,364918,2021-03-20 18:01:17
449,6,Chandigarh,56180,47521,8659,2021-03-20 18:01:17
450,7,Chhattisgarh,1145145,878529,266616,2021-03-20 18:01:17
451,8,Dadra and Nagar Haveli,10130,7128,3002,2021-03-20 18:01:17
452,9,Delhi,853987,661558,192429,2021-03-20 18:01:17
453,10,Goa,81531,67247,14284,2021-03-20 18:01:17
454,11,Gujarat,2918623,2305962,612661,2021-03-20 18:01:17
455,12,Haryana,781362,652493,128869,2021-03-20 18:01:17
456,13,Himachal Pradesh,296853,217475,79378,2021-03-20 18:01:17
457,14,Jammu and Kashmir,495788,390202,105586,2021-03-20 18:01:17
458,15,Jharkhand,670747,465557,205190,2021-03-20 18:01:17
459,16,Karnataka,2196104,1800738,395366,2021-03-20 18:01:17
460,17,Kerala,2097270,1745757,351513,2021-03-20 18:01:17
461,18,Ladakh,40212,35014,5198,2021-03-20 18:01:17
462,19,Lakshadweep,3893,2459,1434,2021-03-20 18:01:17
463,20,Madhya Pradesh,1910900,1455446,455454,2021-03-20 18:01:17
464,21,Maharashtra,3882918,3296052,586866,2021-03-20 18:01:17
465,22,Manipur,80044,60500,19544,2021-03-20 18:01:17
466,23,Meghalaya,74089,52697,21392,2021-03-20 18:01:17
467,24,Mizoram,53048,41019,12029,2021-03-20 18:01:17
468,25,Nagaland,47876,33090,14786,2021-03-20 18:01:17
469,26,Odisha,1339418,1017724,321694,2021-03-20 18:01:17
470,27,Puducherry,40895,35215,5680,2021-03-20 18:01:17
471,28,Punjab,491082,406919,84163,2021-03-20 18:01:17
472,29,Rajasthan,3605058,2972737,632321,2021-03-20 18:01:17
473,30,Sikkim,52879,43023,9856,2021-03-20 18:01:17
474,31,Tamil Nadu,1757593,1574918,182675,2021-03-20 18:01:17
475,32,Telangana,722631,503150,219481,2021-03-20 18:01:17
476,33,Tripura,247925,182567,65358,2021-03-20 18:01:17
477,34,Uttar Pradesh,3586080,2695089,890991,2021-03-20 18:01:17
478,35,Uttarakhand,439697,326606,113091,2021-03-20 18:01:17
479,36,West Bengal,3300451,2806599,493852,2021-03-20 18:01:17
480,37,Daman and Diu,9852,8245,1607,2021-03-20 18:01:17
481,1,Andaman and Nicobar Islands,14481,10882,3599,2021-03-21 18:01:44
482,2,Andhra Pradesh,1413143,1112849,300294,2021-03-21 18:01:44
483,3,Arunachal Pradesh,58108,42024,16084,2021-03-21 18:01:44
484,4,Assam,581927,472604,109323,2021-03-21 18:01:44
485,5,Bihar,1551642,1185439,366203,2021-03-21 18:01:44
486,6,Chandigarh,56345,47681,8664,2021-03-21 18:01:44
487,7,Chhattisgarh,1152698,885295,267403,2021-03-21 18:01:44
488,8,Dadra and Nagar Haveli,10152,7146,3006,2021-03-21 18:01:44
489,9,Delhi,855616,662923,192693,2021-03-21 18:01:44
490,10,Goa,81619,67326,14293,2021-03-21 18:01:44
491,11,Gujarat,3134564,2519042,615522,2021-03-21 18:01:44
492,12,Haryana,789590,660535,129055,2021-03-21 18:01:44
493,13,Himachal Pradesh,299350,219820,79530,2021-03-21 18:01:44
494,14,Jammu and Kashmir,497825,391403,106422,2021-03-21 18:01:44
495,15,Jharkhand,860727,651439,209288,2021-03-21 18:01:44
496,16,Karnataka,2233746,1837037,396709,2021-03-21 18:01:44
497,17,Kerala,2106405,1753913,352492,2021-03-21 18:01:44
498,18,Ladakh,40427,35215,5212,2021-03-21 18:01:44
499,19,Lakshadweep,3896,2461,1435,2021-03-21 18:01:44
500,20,Madhya Pradesh,2036973,1578019,458954,2021-03-21 18:01:44
501,21,Maharashtra,3932253,3341003,591250,2021-03-21 18:01:44
502,22,Manipur,80423,60633,19790,2021-03-21 18:01:44
503,23,Meghalaya,74133,52726,21407,2021-03-21 18:01:44
504,24,Mizoram,53053,41021,12032,2021-03-21 18:01:44
505,25,Nagaland,48173,33370,14803,2021-03-21 18:01:44
506,26,Odisha,1365618,1042813,322805,2021-03-21 18:01:44
507,27,Puducherry,41010,35321,5689,2021-03-21 18:01:44
508,28,Punjab,502366,417750,84616,2021-03-21 18:01:44
509,29,Rajasthan,3670103,3036689,633414,2021-03-21 18:01:44
510,30,Sikkim,53250,43393,9857,2021-03-21 18:01:44
511,31,Tamil Nadu,1800483,1614544,185939,2021-03-21 18:01:44
512,32,Telangana,726460,506903,219557,2021-03-21 18:01:44
513,33,Tripura,257408,191946,65462,2021-03-21 18:01:44
514,34,Uttar Pradesh,3609958,2717635,892323,2021-03-21 18:01:44
515,35,Uttarakhand,443613,330323,113290,2021-03-21 18:01:44
516,36,West Bengal,3334886,2838337,496549,2021-03-21 18:01:44
517,37,Daman and Diu,9877,8264,1613,2021-03-21 18:01:44
518,1,Andaman and Nicobar Islands,15075,11328,3747,2021-03-22 18:01:31
519,2,Andhra Pradesh,1522887,1214160,308727,2021-03-22 18:01:31
520,3,Arunachal Pradesh,61048,44184,16864,2021-03-22 18:01:31
521,4,Assam,608102,491914,116188,2021-03-22 18:01:31
522,5,Bihar,1614145,1242635,371510,2021-03-22 18:01:31
523,6,Chandigarh,58261,49103,9158,2021-03-22 18:01:31
524,7,Chhattisgarh,1205861,930558,275303,2021-03-22 18:01:31
525,8,Dadra and Nagar Haveli,10395,7323,3072,2021-03-22 18:01:31
526,9,Delhi,897181,690820,206361,2021-03-22 18:01:31
527,10,Goa,84840,70034,14806,2021-03-22 18:01:31
528,11,Gujarat,3315525,2693447,622078,2021-03-22 18:01:31
529,12,Haryana,910097,776371,133726,2021-03-22 18:01:31
530,13,Himachal Pradesh,307609,226808,80801,2021-03-22 18:01:31
531,14,Jammu and Kashmir,525537,409847,115690,2021-03-22 18:01:31
532,15,Jharkhand,936110,720509,215601,2021-03-22 18:01:31
533,16,Karnataka,2413098,2007379,405719,2021-03-22 18:01:31
534,17,Kerala,2233463,1873882,359581,2021-03-22 18:01:31
535,18,Ladakh,41218,35519,5699,2021-03-22 18:01:31
536,19,Lakshadweep,3998,2534,1464,2021-03-22 18:01:31
537,20,Madhya Pradesh,2219727,1748365,471362,2021-03-22 18:01:31
538,21,Maharashtra,4151888,3532476,619412,2021-03-22 18:01:31
539,22,Manipur,82875,61168,21707,2021-03-22 18:01:31
540,23,Meghalaya,77592,54131,23461,2021-03-22 18:01:31
541,24,Mizoram,53531,41201,12330,2021-03-22 18:01:31
542,25,Nagaland,52033,35091,16942,2021-03-22 18:01:31
543,26,Odisha,1421576,1094990,326586,2021-03-22 18:01:31
544,27,Puducherry,43932,38033,5899,2021-03-22 18:01:31
545,28,Punjab,535964,448078,87886,2021-03-22 18:01:31
546,29,Rajasthan,3806040,3167011,639029,2021-03-22 18:01:31
547,30,Sikkim,55330,44367,10963,2021-03-22 18:01:31
548,31,Tamil Nadu,1887435,1693725,193710,2021-03-22 18:01:31
549,32,Telangana,761240,540481,220759,2021-03-22 18:01:31
550,33,Tripura,287844,220346,67498,2021-03-22 18:01:31
551,34,Uttar Pradesh,3909554,2960309,949245,2021-03-22 18:01:31
552,35,Uttarakhand,470206,354102,116104,2021-03-22 18:01:31
553,36,West Bengal,3559283,3036693,522590,2021-03-22 18:01:31
554,37,Daman and Diu,10497,8864,1633,2021-03-22 18:01:31
555,1,Andaman and Nicobar Islands,16082,11991,4091,2021-03-23 18:00:59
556,2,Andhra Pradesh,1642442,1322512,319930,2021-03-23 18:00:59
557,3,Arunachal Pradesh,63223,45746,17477,2021-03-23 18:00:59
558,4,Assam,674325,549807,124518,2021-03-23 18:00:59
559,5,Bihar,1721034,1340676,380358,2021-03-23 18:00:59
560,6,Chandigarh,59836,50233,9603,2021-03-23 18:00:59
561,7,Chhattisgarh,1246126,963255,282871,2021-03-23 18:00:59
562,8,Dadra and Nagar Haveli,10709,7523,3186,2021-03-23 18:00:59
563,9,Delhi,938108,719717,218391,2021-03-23 18:00:59
564,10,Goa,88026,72872,15154,2021-03-23 18:00:59
565,11,Gujarat,3543731,2915235,628496,2021-03-23 18:00:59
566,12,Haryana,995554,859632,135922,2021-03-23 18:00:59
567,13,Himachal Pradesh,329407,246784,82623,2021-03-23 18:00:59
568,14,Jammu and Kashmir,549537,427584,121953,2021-03-23 18:00:59
569,15,Jharkhand,1012703,790152,222551,2021-03-23 18:00:59
570,16,Karnataka,2548123,2134476,413647,2021-03-23 18:00:59
571,17,Kerala,2380273,2009125,371148,2021-03-23 18:00:59
572,18,Ladakh,41832,35844,5988,2021-03-23 18:00:59
573,19,Lakshadweep,4121,2602,1519,2021-03-23 18:00:59
574,20,Madhya Pradesh,2263295,1790089,473206,2021-03-23 18:00:59
575,21,Maharashtra,4367732,3724541,643191,2021-03-23 18:00:59
576,22,Manipur,85365,62070,23295,2021-03-23 18:00:59
577,23,Meghalaya,81746,55973,25773,2021-03-23 18:00:59
578,24,Mizoram,54290,41602,12688,2021-03-23 18:00:59
579,25,Nagaland,55553,37452,18101,2021-03-23 18:00:59
580,26,Odisha,1504958,1172448,332510,2021-03-23 18:00:59
581,27,Puducherry,47009,40882,6127,2021-03-23 18:00:59
582,28,Punjab,569356,478590,90766,2021-03-23 18:00:59
583,29,Rajasthan,4023016,3379181,643835,2021-03-23 18:00:59
584,30,Sikkim,57684,45998,11686,2021-03-23 18:00:59
585,31,Tamil Nadu,1997412,1794202,203210,2021-03-23 18:00:59
586,32,Telangana,795787,573012,222775,2021-03-23 18:00:59
587,33,Tripura,330480,261206,69274,2021-03-23 18:00:59
588,34,Uttar Pradesh,4075287,3109134,966153,2021-03-23 18:00:59
589,35,Uttarakhand,498590,380104,118486,2021-03-23 18:00:59
590,36,West Bengal,3777196,3224196,553000,2021-03-23 18:00:59
591,37,Daman and Diu,10979,9320,1659,2021-03-23 18:00:59
592,1,Andaman and Nicobar Islands,16637,12204,4433,2021-03-24 18:02:07
593,2,Andhra Pradesh,1761046,1429904,331142,2021-03-24 18:02:07
594,3,Arunachal Pradesh,63447,45953,17494,2021-03-24 18:02:07
595,4,Assam,769643,641033,128610,2021-03-24 18:02:07
596,5,Bihar,1826355,1438983,387372,2021-03-24 18:02:07
597,6,Chandigarh,61377,51418,9959,2021-03-24 18:02:07
598,7,Chhattisgarh,1289047,1000182,288865,2021-03-24 18:02:07
599,8,Dadra and Nagar Haveli,10938,7707,3231,2021-03-24 18:02:07
600,9,Delhi,965337,739379,225958,2021-03-24 18:02:07
601,10,Goa,91234,75464,15770,2021-03-24 18:02:07
602,11,Gujarat,3734251,3100668,633583,2021-03-24 18:02:07
603,12,Haryana,1018461,881243,137218,2021-03-24 18:02:07
604,13,Himachal Pradesh,342418,258744,83674,2021-03-24 18:02:07
605,14,Jammu and Kashmir,551679,428986,122693,2021-03-24 18:02:07
606,15,Jharkhand,1174600,946887,227713,2021-03-24 18:02:07
607,16,Karnataka,2727713,2305295,422418,2021-03-24 18:02:07
608,17,Kerala,2447424,2070843,376581,2021-03-24 18:02:07
609,18,Ladakh,42217,36133,6084,2021-03-24 18:02:07
610,19,Lakshadweep,4211,2661,1550,2021-03-24 18:02:07
611,20,Madhya Pradesh,2510931,2027391,483540,2021-03-24 18:02:07
612,21,Maharashtra,4615332,3952107,663225,2021-03-24 18:02:07
613,22,Manipur,87860,62795,25065,2021-03-24 18:02:07
614,23,Meghalaya,84439,57414,27025,2021-03-24 18:02:07
615,24,Mizoram,54511,41718,12793,2021-03-24 18:02:07
616,25,Nagaland,57685,38647,19038,2021-03-24 18:02:07
617,26,Odisha,1564690,1229006,335684,2021-03-24 18:02:07
618,27,Puducherry,51628,45391,6237,2021-03-24 18:02:07
619,28,Punjab,601359,508386,92973,2021-03-24 18:02:07
620,29,Rajasthan,4232791,3584881,647910,2021-03-24 18:02:07
621,30,Sikkim,60152,48170,11982,2021-03-24 18:02:07
622,31,Tamil Nadu,2093082,1884011,209071,2021-03-24 18:02:07
623,32,Telangana,830475,606883,223592,2021-03-24 18:02:07
624,33,Tripura,388510,318146,70364,2021-03-24 18:02:07
625,34,Uttar Pradesh,4187991,3216860,971131,2021-03-24 18:02:07
626,35,Uttarakhand,516981,397031,119950,2021-03-24 18:02:07
627,36,West Bengal,3920879,3346878,574001,2021-03-24 18:02:07
628,37,Daman and Diu,11444,9760,1684,2021-03-24 18:02:07
629,1,Andaman and Nicobar Islands,17229,12576,4653,2021-03-25 18:00:44
630,2,Andhra Pradesh,1898860,1553433,345427,2021-03-25 18:00:44
631,3,Arunachal Pradesh,66252,48059,18193,2021-03-25 18:00:44
632,4,Assam,856111,720483,135628,2021-03-25 18:00:44
633,5,Bihar,1951852,1558112,393740,2021-03-25 18:00:44
634,6,Chandigarh,63150,52851,10299,2021-03-25 18:00:44
635,7,Chhattisgarh,1345747,1051023,294724,2021-03-25 18:00:44
636,8,Dadra and Nagar Haveli,11327,8008,3319,2021-03-25 18:00:44
637,9,Delhi,1005009,770993,234016,2021-03-25 18:00:44
638,10,Goa,94180,77908,16272,2021-03-25 18:00:44
639,11,Gujarat,3962656,3324757,637899,2021-03-25 18:00:44
640,12,Haryana,1068509,928653,139856,2021-03-25 18:00:44
641,13,Himachal Pradesh,368693,284141,84552,2021-03-25 18:00:44
642,14,Jammu and Kashmir,584616,455317,129299,2021-03-25 18:00:44
643,15,Jharkhand,1240550,1008754,231796,2021-03-25 18:00:44
644,16,Karnataka,2825002,2397848,427154,2021-03-25 18:00:44
645,17,Kerala,2600312,2217754,382558,2021-03-25 18:00:44
646,18,Ladakh,42407,36215,6192,2021-03-25 18:00:44
647,19,Lakshadweep,4255,2674,1581,2021-03-25 18:00:44
648,20,Madhya Pradesh,2662264,2172167,490097,2021-03-25 18:00:44
649,21,Maharashtra,4826716,4148235,678481,2021-03-25 18:00:44
650,22,Manipur,89855,63351,26504,2021-03-25 18:00:44
651,23,Meghalaya,88435,59516,28919,2021-03-25 18:00:44
652,24,Mizoram,55331,42387,12944,2021-03-25 18:00:44
653,25,Nagaland,59757,39901,19856,2021-03-25 18:00:44
654,26,Odisha,1632419,1292146,340273,2021-03-25 18:00:44
655,27,Puducherry,54348,47992,6356,2021-03-25 18:00:44
656,28,Punjab,637943,542286,95657,2021-03-25 18:00:44
657,29,Rajasthan,4347787,3696337,651450,2021-03-25 18:00:44
658,30,Sikkim,61838,49733,12105,2021-03-25 18:00:44
659,31,Tamil Nadu,2195297,1979991,215306,2021-03-25 18:00:44
660,32,Telangana,869706,643740,225966,2021-03-25 18:00:44
661,33,Tripura,454421,382811,71610,2021-03-25 18:00:44
662,34,Uttar Pradesh,4447400,3452743,994657,2021-03-25 18:00:44
663,35,Uttarakhand,543851,422343,121508,2021-03-25 18:00:44
664,36,West Bengal,4065473,3469231,596242,2021-03-25 18:00:44
665,37,Daman and Diu,11620,9900,1720,2021-03-25 18:00:44
666,1,Andaman and Nicobar Islands,17693,12850,4843,2021-03-26 18:01:09
667,2,Andhra Pradesh,2010321,1651981,358340,2021-03-26 18:01:09
668,3,Arunachal Pradesh,69402,50431,18971,2021-03-26 18:01:09
669,4,Assam,912090,771800,140290,2021-03-26 18:01:09
670,5,Bihar,2070173,1670785,399388,2021-03-26 18:01:09
671,6,Chandigarh,64874,54164,10710,2021-03-26 18:01:09
672,7,Chhattisgarh,1405475,1106455,299020,2021-03-26 18:01:09
673,8,Dadra and Nagar Haveli,11703,8313,3390,2021-03-26 18:01:09
674,9,Delhi,1027800,789065,238735,2021-03-26 18:01:09
675,10,Goa,97296,80349,16947,2021-03-26 18:01:09
676,11,Gujarat,4207205,3564707,642498,2021-03-26 18:01:09
677,12,Haryana,1120332,978230,142102,2021-03-26 18:01:09
678,13,Himachal Pradesh,399716,313780,85936,2021-03-26 18:01:09
679,14,Jammu and Kashmir,611147,477708,133439,2021-03-26 18:01:09
680,15,Jharkhand,1279313,1044396,234917,2021-03-26 18:01:09
681,16,Karnataka,2985069,2550323,434746,2021-03-26 18:01:09
682,17,Kerala,2738046,2350783,387263,2021-03-26 18:01:09
683,18,Ladakh,42617,36298,6319,2021-03-26 18:01:09
684,19,Lakshadweep,4383,2778,1605,2021-03-26 18:01:09
685,20,Madhya Pradesh,2674732,2184219,490513,2021-03-26 18:01:09
686,21,Maharashtra,5081844,4383738,698106,2021-03-26 18:01:09
687,22,Manipur,92331,63986,28345,2021-03-26 18:01:09
688,23,Meghalaya,90713,60890,29823,2021-03-26 18:01:09
689,24,Mizoram,56262,42980,13282,2021-03-26 18:01:09
690,25,Nagaland,60313,40316,19997,2021-03-26 18:01:09
691,26,Odisha,1699331,1355484,343847,2021-03-26 18:01:09
692,27,Puducherry,57138,50614,6524,2021-03-26 18:01:09
693,28,Punjab,674041,576502,97539,2021-03-26 18:01:09
694,29,Rajasthan,4518742,3862719,656023,2021-03-26 18:01:09
695,30,Sikkim,63870,51639,12231,2021-03-26 18:01:09
696,31,Tamil Nadu,2296923,2074637,222286,2021-03-26 18:01:09
697,32,Telangana,909653,680961,228692,2021-03-26 18:01:09
698,33,Tripura,521326,448709,72617,2021-03-26 18:01:09
699,34,Uttar Pradesh,4666249,3663699,1002550,2021-03-26 18:01:09
700,35,Uttarakhand,571972,449106,122866,2021-03-26 18:01:09
701,36,West Bengal,4353226,3735357,617869,2021-03-26 18:01:09
702,37,Daman and Diu,12235,10404,1831,2021-03-26 18:01:09
703,1,Andaman and Nicobar Islands,18248,13198,5050,2021-03-27 18:01:20
704,2,Andhra Pradesh,2129580,1758233,371347,2021-03-27 18:01:20
705,3,Arunachal Pradesh,71572,52455,19117,2021-03-27 18:01:20
706,4,Assam,935497,793702,141795,2021-03-27 18:01:20
707,5,Bihar,2184814,1781028,403786,2021-03-27 18:01:20
708,6,Chandigarh,66447,55473,10974,2021-03-27 18:01:20
709,7,Chhattisgarh,1515104,1212141,302963,2021-03-27 18:01:20
710,8,Dadra and Nagar Haveli,12029,8581,3448,2021-03-27 18:01:20
711,9,Delhi,1067131,823937,243194,2021-03-27 18:01:20
712,10,Goa,99913,82822,17091,2021-03-27 18:01:20
713,11,Gujarat,4464842,3818969,645873,2021-03-27 18:01:20
714,12,Haryana,1144483,1001495,142988,2021-03-27 18:01:20
715,13,Himachal Pradesh,413609,327232,86377,2021-03-27 18:01:20
716,14,Jammu and Kashmir,635632,498870,136762,2021-03-27 18:01:20
717,15,Jharkhand,1371562,1133808,237754,2021-03-27 18:01:20
718,16,Karnataka,3111258,2670967,440291,2021-03-27 18:01:20
719,17,Kerala,2853037,2461902,391135,2021-03-27 18:01:20
720,18,Ladakh,42750,36414,6336,2021-03-27 18:01:20
721,19,Lakshadweep,4580,2958,1622,2021-03-27 18:01:20
722,20,Madhya Pradesh,2778635,2283611,495024,2021-03-27 18:01:20
723,21,Maharashtra,5311270,4599655,711615,2021-03-27 18:01:20
724,22,Manipur,94323,64682,29641,2021-03-27 18:01:20
725,23,Meghalaya,91536,61597,29939,2021-03-27 18:01:20
726,24,Mizoram,56550,43203,13347,2021-03-27 18:01:20
727,25,Nagaland,60525,40436,20089,2021-03-27 18:01:20
728,26,Odisha,1767089,1420555,346534,2021-03-27 18:01:20
729,27,Puducherry,59390,52762,6628,2021-03-27 18:01:20
730,28,Punjab,717043,617606,99437,2021-03-27 18:01:20
731,29,Rajasthan,4716814,4057602,659212,2021-03-27 18:01:20
732,30,Sikkim,64269,52035,12234,2021-03-27 18:01:20
733,31,Tamil Nadu,2397388,2169358,228030,2021-03-27 18:01:20
734,32,Telangana,945935,715923,230012,2021-03-27 18:01:20
735,33,Tripura,545655,472692,72963,2021-03-27 18:01:20
736,34,Uttar Pradesh,4749047,3743585,1005462,2021-03-27 18:01:20
737,35,Uttarakhand,585593,462138,123455,2021-03-27 18:01:20
738,36,West Bengal,4560874,3931429,629445,2021-03-27 18:01:20
739,37,Daman and Diu,12492,10637,1855,2021-03-27 18:01:20
740,1,Andaman and Nicobar Islands,18248,13198,5050,2021-03-28 18:01:15
741,2,Andhra Pradesh,2145969,1773016,372953,2021-03-28 18:01:15
742,3,Arunachal Pradesh,71572,52455,19117,2021-03-28 18:01:15
743,4,Assam,936388,794570,141818,2021-03-28 18:01:15
744,5,Bihar,2207605,1803599,404006,2021-03-28 18:01:15
745,6,Chandigarh,66550,55571,10979,2021-03-28 18:01:15
746,7,Chhattisgarh,1555061,1251620,303441,2021-03-28 18:01:15
747,8,Dadra and Nagar Haveli,12041,8593,3448,2021-03-28 18:01:15
748,9,Delhi,1069734,826381,243353,2021-03-28 18:01:15
749,10,Goa,99913,82822,17091,2021-03-28 18:01:15
750,11,Gujarat,4556786,3910276,646510,2021-03-28 18:01:15
751,12,Haryana,1147285,1004252,143033,2021-03-28 18:01:15
752,13,Himachal Pradesh,423819,337367,86452,2021-03-28 18:01:15
753,14,Jammu and Kashmir,636601,499794,136807,2021-03-28 18:01:15
754,15,Jharkhand,1409576,1171636,237940,2021-03-28 18:01:15
755,16,Karnataka,3130304,2689578,440726,2021-03-28 18:01:15
756,17,Kerala,2864604,2473371,391233,2021-03-28 18:01:15
757,18,Ladakh,42750,36414,6336,2021-03-28 18:01:15
758,19,Lakshadweep,4580,2958,1622,2021-03-28 18:01:15
759,20,Madhya Pradesh,2784392,2289295,495097,2021-03-28 18:01:15
760,21,Maharashtra,5336333,4624153,712180,2021-03-28 18:01:15
761,22,Manipur,94524,64787,29737,2021-03-28 18:01:15
762,23,Meghalaya,91663,61724,29939,2021-03-28 18:01:15
763,24,Mizoram,56550,43203,13347,2021-03-28 18:01:15
764,25,Nagaland,60553,40462,20091,2021-03-28 18:01:15
765,26,Odisha,1771927,1425365,346562,2021-03-28 18:01:15
766,27,Puducherry,59390,52762,6628,2021-03-28 18:01:15
767,28,Punjab,737830,637921,99909,2021-03-28 18:01:15
768,29,Rajasthan,4745994,4086587,659407,2021-03-28 18:01:15
769,30,Sikkim,64269,52035,12234,2021-03-28 18:01:15
770,31,Tamil Nadu,2413249,2184702,228547,2021-03-28 18:01:15
771,32,Telangana,947984,717894,230090,2021-03-28 18:01:15
772,33,Tripura,551907,478889,73018,2021-03-28 18:01:15
773,34,Uttar Pradesh,4750848,3745343,1005505,2021-03-28 18:01:15
774,35,Uttarakhand,586910,463261,123649,2021-03-28 18:01:15
775,36,West Bengal,4570767,3941142,629625,2021-03-28 18:01:15
776,37,Daman and Diu,12521,10665,1856,2021-03-28 18:01:15
777,1,Andaman and Nicobar Islands,18248,13198,5050,2021-03-29 18:00:07
778,2,Andhra Pradesh,2206610,1830558,376052,2021-03-29 18:00:07
779,3,Arunachal Pradesh,72008,52874,19134,2021-03-29 18:00:07
780,4,Assam,939350,797117,142233,2021-03-29 18:00:07
781,5,Bihar,2208179,1804165,404014,2021-03-29 18:00:07
782,6,Chandigarh,66579,55598,10981,2021-03-29 18:00:07
783,7,Chhattisgarh,1555354,1251853,303501,2021-03-29 18:00:07
784,8,Dadra and Nagar Haveli,12051,8603,3448,2021-03-29 18:00:07
785,9,Delhi,1069772,826416,243356,2021-03-29 18:00:07
786,10,Goa,100739,83531,17208,2021-03-29 18:00:07
787,11,Gujarat,4574290,3927290,647000,2021-03-29 18:00:07
788,12,Haryana,1147702,1004658,143044,2021-03-29 18:00:07
789,13,Himachal Pradesh,425027,338554,86473,2021-03-29 18:00:07
790,14,Jammu and Kashmir,659723,519202,140521,2021-03-29 18:00:07
791,15,Jharkhand,1410875,1172838,238037,2021-03-29 18:00:07
792,16,Karnataka,3262254,2815604,446650,2021-03-29 18:00:07
793,17,Kerala,3014902,2619234,395668,2021-03-29 18:00:07
794,18,Ladakh,42750,36414,6336,2021-03-29 18:00:07
795,19,Lakshadweep,4580,2958,1622,2021-03-29 18:00:07
796,20,Madhya Pradesh,2784411,2289312,495099,2021-03-29 18:00:07
797,21,Maharashtra,5390884,4676063,714821,2021-03-29 18:00:07
798,22,Manipur,94527,64787,29740,2021-03-29 18:00:07
799,23,Meghalaya,92762,62580,30182,2021-03-29 18:00:07
800,24,Mizoram,56626,43204,13422,2021-03-29 18:00:07
801,25,Nagaland,60661,40568,20093,2021-03-29 18:00:07
802,26,Odisha,1772219,1425636,346583,2021-03-29 18:00:07
803,27,Puducherry,61240,54521,6719,2021-03-29 18:00:07
804,28,Punjab,758033,657293,100740,2021-03-29 18:00:07
805,29,Rajasthan,4746045,4086638,659407,2021-03-29 18:00:07
806,30,Sikkim,64269,52035,12234,2021-03-29 18:00:07
807,31,Tamil Nadu,2500640,2265589,235051,2021-03-29 18:00:07
808,32,Telangana,960572,730197,230375,2021-03-29 18:00:07
809,33,Tripura,552676,479656,73020,2021-03-29 18:00:07
810,34,Uttar Pradesh,4750919,3745412,1005507,2021-03-29 18:00:07
811,35,Uttarakhand,586910,463261,123649,2021-03-29 18:00:07
812,36,West Bengal,4593675,3962610,631065,2021-03-29 18:00:07
813,37,Daman and Diu,12521,10665,1856,2021-03-29 18:00:07
814,1,Andaman and Nicobar Islands,18715,13591,5124,2021-03-30 18:01:12
815,2,Andhra Pradesh,2292207,1906765,385442,2021-03-30 18:01:12
816,3,Arunachal Pradesh,73878,53998,19880,2021-03-30 18:01:12
817,4,Assam,969315,822167,147148,2021-03-30 18:01:12
818,5,Bihar,2250867,1845376,405491,2021-03-30 18:01:12
819,6,Chandigarh,68243,56817,11426,2021-03-30 18:01:12
820,7,Chhattisgarh,1606866,1299587,307279,2021-03-30 18:01:12
821,8,Dadra and Nagar Haveli,12413,8801,3612,2021-03-30 18:01:12
822,9,Delhi,1111425,860431,250994,2021-03-30 18:01:12
823,10,Goa,104685,86338,18347,2021-03-30 18:01:12
824,11,Gujarat,4774497,4106281,668216,2021-03-30 18:01:12
825,12,Haryana,1252553,1105993,146560,2021-03-30 18:01:12
826,13,Himachal Pradesh,449988,362407,87581,2021-03-30 18:01:12
827,14,Jammu and Kashmir,685541,540748,144793,2021-03-30 18:01:12
828,15,Jharkhand,1420413,1180273,240140,2021-03-30 18:01:12
829,16,Karnataka,3379569,2926807,452762,2021-03-30 18:01:12
830,17,Kerala,3166328,2763944,402384,2021-03-30 18:01:12
831,18,Ladakh,42836,36465,6371,2021-03-30 18:01:12
832,19,Lakshadweep,4732,3042,1690,2021-03-30 18:01:12
833,20,Madhya Pradesh,2787450,2292181,495269,2021-03-30 18:01:12
834,21,Maharashtra,5579924,4852010,727914,2021-03-30 18:01:12
835,22,Manipur,95245,65116,30129,2021-03-30 18:01:12
836,23,Meghalaya,95166,64092,31074,2021-03-30 18:01:12
837,24,Mizoram,56956,43283,13673,2021-03-30 18:01:12
838,25,Nagaland,63856,42646,21210,2021-03-30 18:01:12
839,26,Odisha,1847434,1492912,354522,2021-03-30 18:01:12
840,27,Puducherry,64907,58056,6851,2021-03-30 18:01:12
841,28,Punjab,805939,702117,103822,2021-03-30 18:01:12
842,29,Rajasthan,4823066,4147433,675633,2021-03-30 18:01:12
843,30,Sikkim,65007,52618,12389,2021-03-30 18:01:12
844,31,Tamil Nadu,2570381,2328010,242371,2021-03-30 18:01:12
845,32,Telangana,1004262,771109,233153,2021-03-30 18:01:12
846,33,Tripura,578305,503939,74366,2021-03-30 18:01:12
847,34,Uttar Pradesh,4778284,3771965,1006319,2021-03-30 18:01:12
848,35,Uttarakhand,603812,478060,125752,2021-03-30 18:01:12
849,36,West Bengal,4795608,4147785,647823,2021-03-30 18:01:12
850,37,Daman and Diu,12965,11027,1938,2021-03-30 18:01:12
851,1,Andaman and Nicobar Islands,18787,13662,5125,2021-03-31 18:01:23
852,2,Andhra Pradesh,2383122,1987757,395365,2021-03-31 18:01:23
853,3,Arunachal Pradesh,73883,54002,19881,2021-03-31 18:01:23
854,4,Assam,986527,835752,150775,2021-03-31 18:01:23
855,5,Bihar,2343431,1932541,410890,2021-03-31 18:01:23
856,6,Chandigarh,69884,57930,11954,2021-03-31 18:01:23
857,7,Chhattisgarh,1717131,1402831,314300,2021-03-31 18:01:23
858,8,Dadra and Nagar Haveli,12741,9015,3726,2021-03-31 18:01:23
859,9,Delhi,1139609,880712,258897,2021-03-31 18:01:23
860,10,Goa,107812,88459,19353,2021-03-31 18:01:23
861,11,Gujarat,4978946,4286825,692121,2021-03-31 18:01:23
862,12,Haryana,1328414,1179439,148975,2021-03-31 18:01:23
863,13,Himachal Pradesh,460397,372062,88335,2021-03-31 18:01:23
864,14,Jammu and Kashmir,686892,541985,144907,2021-03-31 18:01:23
865,15,Jharkhand,1440625,1196496,244129,2021-03-31 18:01:23
866,16,Karnataka,3524507,3063586,460921,2021-03-31 18:01:23
867,17,Kerala,3235316,2828819,406497,2021-03-31 18:01:23
868,18,Ladakh,43069,36628,6441,2021-03-31 18:01:23
869,19,Lakshadweep,4937,3221,1716,2021-03-31 18:01:23
870,20,Madhya Pradesh,2923495,2417026,506469,2021-03-31 18:01:23
871,21,Maharashtra,5785682,5040719,744963,2021-03-31 18:01:23
872,22,Manipur,96040,65327,30713,2021-03-31 18:01:23
873,23,Meghalaya,96657,65030,31627,2021-03-31 18:01:23
874,24,Mizoram,57406,43494,13912,2021-03-31 18:01:23
875,25,Nagaland,65965,44166,21799,2021-03-31 18:01:23
876,26,Odisha,1916157,1552372,363785,2021-03-31 18:01:23
877,27,Puducherry,68336,61255,7081,2021-03-31 18:01:23
878,28,Punjab,854840,747358,107482,2021-03-31 18:01:23
879,29,Rajasthan,4947685,4247278,700407,2021-03-31 18:01:23
880,30,Sikkim,65676,53229,12447,2021-03-31 18:01:23
881,31,Tamil Nadu,2635252,2384804,250448,2021-03-31 18:01:23
882,32,Telangana,1038676,802396,236280,2021-03-31 18:01:23
883,33,Tripura,587502,512411,75091,2021-03-31 18:01:23
884,34,Uttar Pradesh,4845076,3836136,1008940,2021-03-31 18:01:23
885,35,Uttarakhand,622136,493567,128569,2021-03-31 18:01:23
886,36,West Bengal,4931264,4267011,664253,2021-03-31 18:01:23
887,37,Daman and Diu,13532,11536,1996,2021-03-31 18:01:23
888,1,Andaman and Nicobar Islands,19379,14221,5158,2021-04-01 18:00:06
889,2,Andhra Pradesh,2470482,2067845,402637,2021-04-01 18:00:06
890,3,Arunachal Pradesh,79344,58015,21329,2021-04-01 18:00:06
891,4,Assam,1014416,858408,156008,2021-04-01 18:00:06
892,5,Bihar,2441986,2025880,416106,2021-04-01 18:00:06
893,6,Chandigarh,73172,60717,12455,2021-04-01 18:00:06
894,7,Chhattisgarh,1841271,1521458,319813,2021-04-01 18:00:06
895,8,Dadra and Nagar Haveli,14355,10519,3836,2021-04-01 18:00:06
896,9,Delhi,1199089,932777,266312,2021-04-01 18:00:06
897,10,Goa,111214,91072,20142,2021-04-01 18:00:06
898,11,Gujarat,5235317,4521470,713847,2021-04-01 18:00:06
899,12,Haryana,1396502,1244320,152182,2021-04-01 18:00:06
900,13,Himachal Pradesh,495402,406266,89136,2021-04-01 18:00:06
901,14,Jammu and Kashmir,715478,566786,148692,2021-04-01 18:00:06
902,15,Jharkhand,1465365,1217859,247506,2021-04-01 18:00:06
903,16,Karnataka,3612088,3146857,465231,2021-04-01 18:00:06
904,17,Kerala,3316136,2906360,409776,2021-04-01 18:00:06
905,18,Ladakh,46198,39710,6488,2021-04-01 18:00:06
906,19,Lakshadweep,5059,3336,1723,2021-04-01 18:00:06
907,20,Madhya Pradesh,3155675,2640922,514753,2021-04-01 18:00:06
908,21,Maharashtra,6002637,5247189,755448,2021-04-01 18:00:06
909,22,Manipur,97117,65656,31461,2021-04-01 18:00:06
910,23,Meghalaya,99937,67614,32323,2021-04-01 18:00:06
911,24,Mizoram,58563,44072,14491,2021-04-01 18:00:06
912,25,Nagaland,67891,45651,22240,2021-04-01 18:00:06
913,26,Odisha,1990236,1620908,369328,2021-04-01 18:00:06
914,27,Puducherry,70183,62930,7253,2021-04-01 18:00:06
915,28,Punjab,910968,800104,110864,2021-04-01 18:00:06
916,29,Rajasthan,5117512,4394848,722664,2021-04-01 18:00:06
917,30,Sikkim,68799,56210,12589,2021-04-01 18:00:06
918,31,Tamil Nadu,2685483,2428716,256767,2021-04-01 18:00:06
919,32,Telangana,1087616,847787,239829,2021-04-01 18:00:06
920,33,Tripura,601884,525696,76188,2021-04-01 18:00:06
921,34,Uttar Pradesh,5033572,4012217,1021355,2021-04-01 18:00:06
922,35,Uttarakhand,657351,526133,131218,2021-04-01 18:00:06
923,36,West Bengal,5081204,4404217,676987,2021-04-01 18:00:06
924,37,Daman and Diu,14348,12285,2063,2021-04-01 18:00:06
925,1,Andaman and Nicobar Islands,19427,14264,5163,2021-04-02 18:02:01
926,2,Andhra Pradesh,2546815,2138953,407862,2021-04-02 18:02:01
927,3,Arunachal Pradesh,80734,59156,21578,2021-04-02 18:02:01
928,4,Assam,1047048,884319,162729,2021-04-02 18:02:01
929,5,Bihar,2582464,2159893,422571,2021-04-02 18:02:01
930,6,Chandigarh,76320,63532,12788,2021-04-02 18:02:01
931,7,Chhattisgarh,2054154,1727095,327059,2021-04-02 18:02:01
932,8,Dadra and Nagar Haveli,16575,12576,3999,2021-04-02 18:02:01
933,9,Delhi,1262423,990036,272387,2021-04-02 18:02:01
934,10,Goa,114466,93815,20651,2021-04-02 18:02:01
935,11,Gujarat,5623459,4876277,747182,2021-04-02 18:02:01
936,12,Haryana,1472546,1316935,155611,2021-04-02 18:02:01
937,13,Himachal Pradesh,515705,425959,89746,2021-04-02 18:02:01
938,14,Jammu and Kashmir,749089,596695,152394,2021-04-02 18:02:01
939,15,Jharkhand,1500288,1249300,250988,2021-04-02 18:02:01
940,16,Karnataka,3790154,3319465,470689,2021-04-02 18:02:01
941,17,Kerala,3378681,2965596,413085,2021-04-02 18:02:01
942,18,Ladakh,51287,44766,6521,2021-04-02 18:02:01
943,19,Lakshadweep,5200,3466,1734,2021-04-02 18:02:01
944,20,Madhya Pradesh,3307946,2788162,519784,2021-04-02 18:02:01
945,21,Maharashtra,6300058,5532014,768044,2021-04-02 18:02:01
946,22,Manipur,97381,65724,31657,2021-04-02 18:02:01
947,23,Meghalaya,100623,68203,32420,2021-04-02 18:02:01
948,24,Mizoram,58703,44169,14534,2021-04-02 18:02:01
949,25,Nagaland,68095,45814,22281,2021-04-02 18:02:01
950,26,Odisha,2119972,1742253,377719,2021-04-02 18:02:01
951,27,Puducherry,71163,63765,7398,2021-04-02 18:02:01
952,28,Punjab,975563,861495,114068,2021-04-02 18:02:01
953,29,Rajasthan,5375240,4619409,755831,2021-04-02 18:02:01
954,30,Sikkim,69225,56621,12604,2021-04-02 18:02:01
955,31,Tamil Nadu,2737047,2473042,264005,2021-04-02 18:02:01
956,32,Telangana,1145852,901839,244013,2021-04-02 18:02:01
957,33,Tripura,608251,531504,76747,2021-04-02 18:02:01
958,34,Uttar Pradesh,5352563,4314932,1037631,2021-04-02 18:02:01
959,35,Uttarakhand,704580,569754,134826,2021-04-02 18:02:01
960,36,West Bengal,5224307,4537164,687143,2021-04-02 18:02:01
961,37,Daman and Diu,15569,13416,2153,2021-04-02 18:02:01
962,1,Andaman and Nicobar Islands,19894,14687,5207,2021-04-03 18:03:52
963,2,Andhra Pradesh,2610240,2194108,416132,2021-04-03 18:03:52
964,3,Arunachal Pradesh,84349,62019,22330,2021-04-03 18:03:52
965,4,Assam,1079483,908571,170912,2021-04-03 18:03:52
966,5,Bihar,2670030,2242558,427472,2021-04-03 18:03:52
967,6,Chandigarh,79658,66380,13278,2021-04-03 18:03:52
968,7,Chhattisgarh,2236398,1903256,333142,2021-04-03 18:03:52
969,8,Dadra and Nagar Haveli,18381,14213,4168,2021-04-03 18:03:52
970,9,Delhi,1322883,1043400,279483,2021-04-03 18:03:52
971,10,Goa,117634,96201,21433,2021-04-03 18:03:52
972,11,Gujarat,5913787,5141069,772718,2021-04-03 18:03:52
973,12,Haryana,1509738,1352284,157454,2021-04-03 18:03:52
974,13,Himachal Pradesh,532283,441617,90666,2021-04-03 18:03:52
975,14,Jammu and Kashmir,775070,619576,155494,2021-04-03 18:03:52
976,15,Jharkhand,1522388,1268334,254054,2021-04-03 18:03:52
977,16,Karnataka,3960816,3484652,476164,2021-04-03 18:03:52
978,17,Kerala,3491979,3071403,420576,2021-04-03 18:03:52
979,18,Ladakh,54714,48148,6566,2021-04-03 18:03:52
980,19,Lakshadweep,5346,3594,1752,2021-04-03 18:03:52
981,20,Madhya Pradesh,3448796,2922262,526534,2021-04-03 18:03:52
982,21,Maharashtra,6595599,5814174,781425,2021-04-03 18:03:52
983,22,Manipur,99715,66321,33394,2021-04-03 18:03:52
984,23,Meghalaya,101597,68966,32631,2021-04-03 18:03:52
985,24,Mizoram,58759,44211,14548,2021-04-03 18:03:52
986,25,Nagaland,68212,45847,22365,2021-04-03 18:03:52
987,26,Odisha,2212862,1828862,384000,2021-04-03 18:03:52
988,27,Puducherry,74414,66847,7567,2021-04-03 18:03:52
989,28,Punjab,1039668,922080,117588,2021-04-03 18:03:52
990,29,Rajasthan,5589638,4805054,784584,2021-04-03 18:03:52
991,30,Sikkim,69720,57116,12604,2021-04-03 18:03:52
992,31,Tamil Nadu,2775467,2505308,270159,2021-04-03 18:03:52
993,32,Telangana,1190832,942868,247964,2021-04-03 18:03:52
994,33,Tripura,616859,538989,77870,2021-04-03 18:03:52
995,34,Uttar Pradesh,5543202,4496230,1046972,2021-04-03 18:03:52
996,35,Uttarakhand,743579,605114,138465,2021-04-03 18:03:52
997,36,West Bengal,5379232,4678975,700257,2021-04-03 18:03:52
998,37,Daman and Diu,17555,15256,2299,2021-04-03 18:03:52
999,1,Andaman and Nicobar Islands,20134,14927,5207,2021-04-04 18:02:27
1000,2,Andhra Pradesh,2642003,2224056,417947,2021-04-04 18:02:27
1001,3,Arunachal Pradesh,84743,62366,22377,2021-04-04 18:02:27
1002,4,Assam,1084912,912757,172155,2021-04-04 18:02:27
1003,5,Bihar,2719249,2289857,429392,2021-04-04 18:02:27
1004,6,Chandigarh,81817,68365,13452,2021-04-04 18:02:27
1005,7,Chhattisgarh,2396893,2059025,337868,2021-04-04 18:02:27
1006,8,Dadra and Nagar Haveli,19583,15356,4227,2021-04-04 18:02:27
1007,9,Delhi,1381063,1098155,282908,2021-04-04 18:02:27
1008,10,Goa,118980,97450,21530,2021-04-04 18:02:27
1009,11,Gujarat,6137038,5344725,792313,2021-04-04 18:02:27
1010,12,Haryana,1533620,1375362,158258,2021-04-04 18:02:27
1011,13,Himachal Pradesh,545702,454339,91363,2021-04-04 18:02:27
1012,14,Jammu and Kashmir,790885,634454,156431,2021-04-04 18:02:27
1013,15,Jharkhand,1580390,1324177,256213,2021-04-04 18:02:27
1014,16,Karnataka,4037136,3559181,477955,2021-04-04 18:02:27
1015,17,Kerala,3511571,3090061,421510,2021-04-04 18:02:27
1016,18,Ladakh,56144,49575,6569,2021-04-04 18:02:27
1017,19,Lakshadweep,5440,3686,1754,2021-04-04 18:02:27
1018,20,Madhya Pradesh,3501561,2973697,527864,2021-04-04 18:02:27
1019,21,Maharashtra,6772628,5985516,787112,2021-04-04 18:02:27
1020,22,Manipur,100061,66433,33628,2021-04-04 18:02:27
1021,23,Meghalaya,101789,69150,32639,2021-04-04 18:02:27
1022,24,Mizoram,58765,44212,14553,2021-04-04 18:02:27
1023,25,Nagaland,68231,45864,22367,2021-04-04 18:02:27
1024,26,Odisha,2317745,1928830,388915,2021-04-04 18:02:27
1025,27,Puducherry,75233,67615,7618,2021-04-04 18:02:27
1026,28,Punjab,1096347,976950,119397,2021-04-04 18:02:27
1027,29,Rajasthan,5814407,5006018,808389,2021-04-04 18:02:27
1028,30,Sikkim,69865,57261,12604,2021-04-04 18:02:27
1029,31,Tamil Nadu,2787196,2515097,272099,2021-04-04 18:02:27
1030,32,Telangana,1214227,964925,249302,2021-04-04 18:02:27
1031,33,Tripura,618964,540977,77987,2021-04-04 18:02:27
1032,34,Uttar Pradesh,5578782,4529699,1049083,2021-04-04 18:02:27
1033,35,Uttarakhand,771924,631483,140441,2021-04-04 18:02:27
1034,36,West Bengal,5455792,4750061,705731,2021-04-04 18:02:27
1035,37,Daman and Diu,18191,15833,2358,2021-04-04 18:02:27
1036,1,Andaman and Nicobar Islands,20984,15726,5258,2021-04-05 18:02:24
1037,2,Andhra Pradesh,2711499,2284003,427496,2021-04-05 18:02:24
1038,3,Arunachal Pradesh,88742,65265,23477,2021-04-05 18:02:24
1039,4,Assam,1119578,938912,180666,2021-04-05 18:02:24
1040,5,Bihar,2830646,2393644,437002,2021-04-05 18:02:24
1041,6,Chandigarh,85190,71158,14032,2021-04-05 18:02:24
1042,7,Chhattisgarh,2499476,2156610,342866,2021-04-05 18:02:24
1043,8,Dadra and Nagar Haveli,21748,17260,4488,2021-04-05 18:02:24
1044,9,Delhi,1449236,1157605,291631,2021-04-05 18:02:24
1045,10,Goa,122712,100045,22667,2021-04-05 18:02:24
1046,11,Gujarat,6373342,5553043,820299,2021-04-05 18:02:24
1047,12,Haryana,1607559,1445526,162033,2021-04-05 18:02:24
1048,13,Himachal Pradesh,573718,481112,92606,2021-04-05 18:02:24
1049,14,Jammu and Kashmir,826387,666709,159678,2021-04-05 18:02:24
1050,15,Jharkhand,1645163,1385774,259389,2021-04-05 18:02:24
1051,16,Karnataka,4192604,3707500,485104,2021-04-05 18:02:24
1052,17,Kerala,3627327,3198962,428365,2021-04-05 18:02:24
1053,18,Ladakh,58867,52262,6605,2021-04-05 18:02:24
1054,19,Lakshadweep,5675,3891,1784,2021-04-05 18:02:24
1055,20,Madhya Pradesh,3645106,3111534,533572,2021-04-05 18:02:24
1056,21,Maharashtra,7088231,6285095,803136,2021-04-05 18:02:24
1057,22,Manipur,102248,67098,35150,2021-04-05 18:02:24
1058,23,Meghalaya,104119,70775,33344,2021-04-05 18:02:24
1059,24,Mizoram,60422,44948,15474,2021-04-05 18:02:24
1060,25,Nagaland,70896,47710,23186,2021-04-05 18:02:24
1061,26,Odisha,2420482,2023885,396597,2021-04-05 18:02:24
1062,27,Puducherry,76674,68859,7815,2021-04-05 18:02:24
1063,28,Punjab,1166217,1042778,123439,2021-04-05 18:02:24
1064,29,Rajasthan,6106807,5261627,845180,2021-04-05 18:02:24
1065,30,Sikkim,72651,59867,12784,2021-04-05 18:02:24
1066,31,Tamil Nadu,2826303,2546405,279898,2021-04-05 18:02:24
1067,32,Telangana,1267662,1013919,253743,2021-04-05 18:02:24
1068,33,Tripura,632206,552140,80066,2021-04-05 18:02:24
1069,34,Uttar Pradesh,5841032,4759716,1081316,2021-04-05 18:02:24
1070,35,Uttarakhand,820218,675359,144859,2021-04-05 18:02:24
1071,36,West Bengal,5687288,4963390,723898,2021-04-05 18:02:24
1072,37,Daman and Diu,19606,17102,2504,2021-04-05 18:02:24
1073,1,Andaman and Nicobar Islands,21378,16103,5275,2021-04-06 18:02:03
1074,2,Andhra Pradesh,2758179,2326042,432137,2021-04-06 18:02:03
1075,3,Arunachal Pradesh,90198,66343,23855,2021-04-06 18:02:03
1076,4,Assam,1132478,948846,183632,2021-04-06 18:02:03
1077,5,Bihar,2891310,2449977,441333,2021-04-06 18:02:03
1078,6,Chandigarh,86497,72170,14327,2021-04-06 18:02:03
1079,7,Chhattisgarh,2543768,2198412,345356,2021-04-06 18:02:03
1080,8,Dadra and Nagar Haveli,22525,17959,4566,2021-04-06 18:02:03
1081,9,Delhi,1476309,1180874,295435,2021-04-06 18:02:03
1082,10,Goa,124275,101192,23083,2021-04-06 18:02:03
1083,11,Gujarat,6459109,5628071,831038,2021-04-06 18:02:03
1084,12,Haryana,1633542,1470031,163511,2021-04-06 18:02:03
1085,13,Himachal Pradesh,594336,500830,93506,2021-04-06 18:02:03
1086,14,Jammu and Kashmir,842465,681040,161425,2021-04-06 18:02:03
1087,15,Jharkhand,1660596,1399883,260713,2021-04-06 18:02:03
1088,16,Karnataka,4259504,3771557,487947,2021-04-06 18:02:03
1089,17,Kerala,3644312,3214640,429672,2021-04-06 18:02:03
1090,18,Ladakh,59788,53109,6679,2021-04-06 18:02:03
1091,19,Lakshadweep,5824,4025,1799,2021-04-06 18:02:03
1092,20,Madhya Pradesh,3711867,3175301,536566,2021-04-06 18:02:03
1093,21,Maharashtra,7224988,6415063,809925,2021-04-06 18:02:03
1094,22,Manipur,103043,67391,35652,2021-04-06 18:02:03
1095,23,Meghalaya,105396,71690,33706,2021-04-06 18:02:03
1096,24,Mizoram,61685,45642,16043,2021-04-06 18:02:03
1097,25,Nagaland,71908,48444,23464,2021-04-06 18:02:03
1098,26,Odisha,2455251,2055648,399603,2021-04-06 18:02:03
1099,27,Puducherry,76986,69140,7846,2021-04-06 18:02:03
1100,28,Punjab,1194657,1069523,125134,2021-04-06 18:02:03
1101,29,Rajasthan,6231000,5372815,858185,2021-04-06 18:02:03
1102,30,Sikkim,74597,61702,12895,2021-04-06 18:02:03
1103,31,Tamil Nadu,2835983,2554158,281825,2021-04-06 18:02:03
1104,32,Telangana,1288419,1032463,255956,2021-04-06 18:02:03
1105,33,Tripura,635644,555196,80448,2021-04-06 18:02:03
1106,34,Uttar Pradesh,5970506,4879115,1091391,2021-04-06 18:02:03
1107,35,Uttarakhand,845267,698212,147055,2021-04-06 18:02:03
1108,36,West Bengal,5787059,5054804,732255,2021-04-06 18:02:03
1109,37,Daman and Diu,20487,17926,2561,2021-04-06 18:02:03
1110,1,Andaman and Nicobar Islands,22410,17128,5282,2021-04-07 18:02:42
1111,2,Andhra Pradesh,2816024,2375651,440373,2021-04-07 18:02:42
1112,3,Arunachal Pradesh,91673,67523,24150,2021-04-07 18:02:42
1113,4,Assam,1150362,960708,189654,2021-04-07 18:02:42
1114,5,Bihar,2967848,2517150,450698,2021-04-07 18:02:42
1115,6,Chandigarh,89796,74873,14923,2021-04-07 18:02:42
1116,7,Chhattisgarh,2642966,2292926,350040,2021-04-07 18:02:42
1117,8,Dadra and Nagar Haveli,23537,18901,4636,2021-04-07 18:02:42
1118,9,Delhi,1506584,1205452,301132,2021-04-07 18:02:42
1119,10,Goa,128083,104066,24017,2021-04-07 18:02:42
1120,11,Gujarat,6545171,5703376,841795,2021-04-07 18:02:42
1121,12,Haryana,1654998,1489511,165487,2021-04-07 18:02:42
1122,13,Himachal Pradesh,629290,534269,95021,2021-04-07 18:02:42
1123,14,Jammu and Kashmir,877647,713825,163822,2021-04-07 18:02:42
1124,15,Jharkhand,1714450,1450308,264142,2021-04-07 18:02:42
1125,16,Karnataka,4432810,3935167,497643,2021-04-07 18:02:42
1126,17,Kerala,3719910,3284197,435713,2021-04-07 18:02:42
1127,18,Ladakh,61035,54209,6826,2021-04-07 18:02:42
1128,19,Lakshadweep,6168,4297,1871,2021-04-07 18:02:42
1129,20,Madhya Pradesh,3931710,3385734,545976,2021-04-07 18:02:42
1130,21,Maharashtra,7510582,6682989,827593,2021-04-07 18:02:42
1131,22,Manipur,104852,67995,36857,2021-04-07 18:02:42
1132,23,Meghalaya,108239,73805,34434,2021-04-07 18:02:42
1133,24,Mizoram,64829,48172,16657,2021-04-07 18:02:42
1134,25,Nagaland,75172,51324,23848,2021-04-07 18:02:42
1135,26,Odisha,2502294,2099008,403286,2021-04-07 18:02:42
1136,27,Puducherry,78117,70097,8020,2021-04-07 18:02:42
1137,28,Punjab,1246789,1118418,128371,2021-04-07 18:02:42
1138,29,Rajasthan,6530722,5645834,884888,2021-04-07 18:02:42
1139,30,Sikkim,78766,65582,13184,2021-04-07 18:02:42
1140,31,Tamil Nadu,2872820,2582510,290310,2021-04-07 18:02:42
1141,32,Telangana,1347364,1085753,261611,2021-04-07 18:02:42
1142,33,Tripura,639965,558514,81451,2021-04-07 18:02:42
1143,34,Uttar Pradesh,6121932,5021335,1100597,2021-04-07 18:02:42
1144,35,Uttarakhand,886605,735340,151265,2021-04-07 18:02:42
1145,36,West Bengal,5936346,5183481,752865,2021-04-07 18:02:42
1146,37,Daman and Diu,21798,19146,2652,2021-04-07 18:02:42
1147,1,Andaman and Nicobar Islands,24661,19339,5322,2021-04-08 18:02:39
1148,2,Andhra Pradesh,2939577,2485564,454013,2021-04-08 18:02:39
1149,3,Arunachal Pradesh,97972,72254,25718,2021-04-08 18:02:39
1150,4,Assam,1208856,1001859,206997,2021-04-08 18:02:39
1151,5,Bihar,3101908,2633818,468090,2021-04-08 18:02:39
1152,6,Chandigarh,93946,78151,15795,2021-04-08 18:02:39
1153,7,Chhattisgarh,2932043,2567465,364578,2021-04-08 18:02:39
1154,8,Dadra and Nagar Haveli,25853,20980,4873,2021-04-08 18:02:39
1155,9,Delhi,1612207,1296183,316024,2021-04-08 18:02:39
1156,10,Goa,133439,108151,25288,2021-04-08 18:02:39
1157,11,Gujarat,6868620,5975784,892836,2021-04-08 18:02:39
1158,12,Haryana,1729451,1558514,170937,2021-04-08 18:02:39
1159,13,Himachal Pradesh,692560,595201,97359,2021-04-08 18:02:39
1160,14,Jammu and Kashmir,962387,791381,171006,2021-04-08 18:02:39
1161,15,Jharkhand,1771977,1503628,268349,2021-04-08 18:02:39
1162,16,Karnataka,4683470,4171542,511928,2021-04-08 18:02:39
1163,17,Kerala,3929588,3478932,450656,2021-04-08 18:02:39
1164,18,Ladakh,62914,55751,7163,2021-04-08 18:02:39
1165,19,Lakshadweep,7059,5065,1994,2021-04-08 18:02:39
1166,20,Madhya Pradesh,4226324,3666133,560191,2021-04-08 18:02:39
1167,21,Maharashtra,7955411,7095183,860228,2021-04-08 18:02:39
1168,22,Manipur,107525,68915,38610,2021-04-08 18:02:39
1169,23,Meghalaya,113801,78085,35716,2021-04-08 18:02:39
1170,24,Mizoram,70101,52095,18006,2021-04-08 18:02:39
1171,25,Nagaland,79412,54841,24571,2021-04-08 18:02:39
1172,26,Odisha,2653632,2237293,416339,2021-04-08 18:02:39
1173,27,Puducherry,80630,72195,8435,2021-04-08 18:02:39
1174,28,Punjab,1336054,1202889,133165,2021-04-08 18:02:39
1175,29,Rajasthan,7066835,6130211,936624,2021-04-08 18:02:39
1176,30,Sikkim,87707,73766,13941,2021-04-08 18:02:39
1177,31,Tamil Nadu,2965384,2652482,312902,2021-04-08 18:02:39
1178,32,Telangana,1444836,1175563,269273,2021-04-08 18:02:39
1179,33,Tripura,657644,573717,83927,2021-04-08 18:02:39
1180,34,Uttar Pradesh,6437562,5317806,1119756,2021-04-08 18:02:39
1181,35,Uttarakhand,958190,799906,158284,2021-04-08 18:02:39
1182,36,West Bengal,6202335,5403051,799284,2021-04-08 18:02:39
1183,37,Daman and Diu,23312,20486,2826,2021-04-08 18:02:39
1184,1,Andaman and Nicobar Islands,26884,21455,5429,2021-04-09 18:02:30
1185,2,Andhra Pradesh,3046766,2578642,468124,2021-04-09 18:02:30
1186,3,Arunachal Pradesh,104161,77226,26935,2021-04-09 18:02:30
1187,4,Assam,1257351,1035377,221974,2021-04-09 18:02:30
1188,5,Bihar,3149782,2673439,476343,2021-04-09 18:02:30
1189,6,Chandigarh,98224,81533,16691,2021-04-09 18:02:30
1190,7,Chhattisgarh,3144936,2769442,375494,2021-04-09 18:02:30
1191,8,Dadra and Nagar Haveli,27574,22561,5013,2021-04-09 18:02:30
1192,9,Delhi,1669884,1342510,327374,2021-04-09 18:02:30
1193,10,Goa,139903,112806,27097,2021-04-09 18:02:30
1194,11,Gujarat,7139306,6197778,941528,2021-04-09 18:02:30
1195,12,Haryana,1812624,1633577,179047,2021-04-09 18:02:30
1196,13,Himachal Pradesh,746897,646786,100111,2021-04-09 18:02:30
1197,14,Jammu and Kashmir,1023804,848480,175324,2021-04-09 18:02:30
1198,15,Jharkhand,1790148,1518829,271319,2021-04-09 18:02:30
1199,16,Karnataka,4988327,4456890,531437,2021-04-09 18:02:30
1200,17,Kerala,4144204,3674554,469650,2021-04-09 18:02:30
1201,18,Ladakh,63749,56267,7482,2021-04-09 18:02:30
1202,19,Lakshadweep,7607,5545,2062,2021-04-09 18:02:30
1203,20,Madhya Pradesh,4328816,3762176,566640,2021-04-09 18:02:30
1204,21,Maharashtra,8234316,7348258,886058,2021-04-09 18:02:30
1205,22,Manipur,110188,70211,39977,2021-04-09 18:02:30
1206,23,Meghalaya,117707,81017,36690,2021-04-09 18:02:30
1207,24,Mizoram,75441,55851,19590,2021-04-09 18:02:30
1208,25,Nagaland,81860,56854,25006,2021-04-09 18:02:30
1209,26,Odisha,2811432,2378831,432601,2021-04-09 18:02:30
1210,27,Puducherry,83116,74266,8850,2021-04-09 18:02:30
1211,28,Punjab,1434403,1295854,138549,2021-04-09 18:02:30
1212,29,Rajasthan,7437576,6463674,973902,2021-04-09 18:02:30
1213,30,Sikkim,95557,80977,14580,2021-04-09 18:02:30
1214,31,Tamil Nadu,3074756,2739287,335469,2021-04-09 18:02:30
1215,32,Telangana,1557565,1280351,277214,2021-04-09 18:02:30
1216,33,Tripura,672661,586564,86097,2021-04-09 18:02:30
1217,34,Uttar Pradesh,6673993,5521650,1152343,2021-04-09 18:02:30
1218,35,Uttarakhand,1015847,851581,164266,2021-04-09 18:02:30
1219,36,West Bengal,6541838,5701323,840515,2021-04-09 18:02:30
1220,37,Daman and Diu,25257,22278,2979,2021-04-09 18:02:30
1221,1,Andaman and Nicobar Islands,28966,23488,5478,2021-04-10 18:02:56
1222,2,Andhra Pradesh,3217034,2719679,497355,2021-04-10 18:02:56
1223,3,Arunachal Pradesh,108760,80820,27940,2021-04-10 18:02:56
1224,4,Assam,1287110,1054443,232667,2021-04-10 18:02:56
1225,5,Bihar,3371253,2870831,500422,2021-04-10 18:02:56
1226,6,Chandigarh,102966,85346,17620,2021-04-10 18:02:56
1227,7,Chhattisgarh,3325082,2938482,386600,2021-04-10 18:02:56
1228,8,Dadra and Nagar Haveli,29293,24095,5198,2021-04-10 18:02:56
1229,9,Delhi,1774359,1433241,341118,2021-04-10 18:02:56
1230,10,Goa,148720,119733,28987,2021-04-10 18:02:56
1231,11,Gujarat,7397808,6409597,988211,2021-04-10 18:02:56
1232,12,Haryana,1875904,1690160,185744,2021-04-10 18:02:56
1233,13,Himachal Pradesh,796799,694233,102566,2021-04-10 18:02:56
1234,14,Jammu and Kashmir,1066780,887749,179031,2021-04-10 18:02:56
1235,15,Jharkhand,1875999,1598556,277443,2021-04-10 18:02:56
1236,16,Karnataka,5273768,4725067,548701,2021-04-10 18:02:56
1237,17,Kerala,4328384,3842495,485889,2021-04-10 18:02:56
1238,18,Ladakh,64244,56524,7720,2021-04-10 18:02:56
1239,19,Lakshadweep,8537,6412,2125,2021-04-10 18:02:56
1240,20,Madhya Pradesh,4425408,3852256,573152,2021-04-10 18:02:56
1241,21,Maharashtra,8513846,7604981,908865,2021-04-10 18:02:56
1242,22,Manipur,111314,70690,40624,2021-04-10 18:02:56
1243,23,Meghalaya,120122,83158,36964,2021-04-10 18:02:56
1244,24,Mizoram,77764,57763,20001,2021-04-10 18:02:56
1245,25,Nagaland,82832,57715,25117,2021-04-10 18:02:56
1246,26,Odisha,2914671,2470285,444386,2021-04-10 18:02:56
1247,27,Puducherry,86616,77335,9281,2021-04-10 18:02:56
1248,28,Punjab,1528357,1384354,144003,2021-04-10 18:02:56
1249,29,Rajasthan,7715277,6708632,1006645,2021-04-10 18:02:56
1250,30,Sikkim,98515,83727,14788,2021-04-10 18:02:56
1251,31,Tamil Nadu,3187721,2829424,358297,2021-04-10 18:02:56
1252,32,Telangana,1712344,1425354,286990,2021-04-10 18:02:56
1253,33,Tripura,680880,593421,87459,2021-04-10 18:02:56
1254,34,Uttar Pradesh,6765805,5603332,1162473,2021-04-10 18:02:56
1255,35,Uttarakhand,1055852,886544,169308,2021-04-10 18:02:56
1256,36,West Bengal,6750982,5881849,869133,2021-04-10 18:02:56
1257,37,Daman and Diu,27308,24178,3130,2021-04-10 18:02:56
1258,1,Andaman and Nicobar Islands,30495,24983,5512,2021-04-11 18:04:18
1259,2,Andhra Pradesh,3323793,2819734,504059,2021-04-11 18:04:18
1260,3,Arunachal Pradesh,111917,83707,28210,2021-04-11 18:04:18
1261,4,Assam,1293896,1059108,234788,2021-04-11 18:04:18
1262,5,Bihar,3571196,3055959,515237,2021-04-11 18:04:18
1263,6,Chandigarh,105391,87454,17937,2021-04-11 18:04:18
1264,7,Chhattisgarh,3473528,3079453,394075,2021-04-11 18:04:18
1265,8,Dadra and Nagar Haveli,30526,25214,5312,2021-04-11 18:04:18
1266,9,Delhi,1848648,1501188,347460,2021-04-11 18:04:18
1267,10,Goa,155467,126167,29300,2021-04-11 18:04:18
1268,11,Gujarat,7573671,6558364,1015307,2021-04-11 18:04:18
1269,12,Haryana,1956218,1765313,190905,2021-04-11 18:04:18
1270,13,Himachal Pradesh,832421,728232,104189,2021-04-11 18:04:18
1271,14,Jammu and Kashmir,1094250,913730,180520,2021-04-11 18:04:18
1272,15,Jharkhand,1966840,1685288,281552,2021-04-11 18:04:18
1273,16,Karnataka,5400354,4844756,555598,2021-04-11 18:04:18
1274,17,Kerala,4383690,3894114,489576,2021-04-11 18:04:18
1275,18,Ladakh,64920,56961,7959,2021-04-11 18:04:18
1276,19,Lakshadweep,8893,6744,2149,2021-04-11 18:04:18
1277,20,Madhya Pradesh,4740493,4152382,588111,2021-04-11 18:04:18
1278,21,Maharashtra,8739938,7815990,923948,2021-04-11 18:04:18
1279,22,Manipur,113155,72193,40962,2021-04-11 18:04:18
1280,23,Meghalaya,120688,83723,36965,2021-04-11 18:04:18
1281,24,Mizoram,78096,58047,20049,2021-04-11 18:04:18
1282,25,Nagaland,86245,61021,25224,2021-04-11 18:04:18
1283,26,Odisha,2995815,2542625,453190,2021-04-11 18:04:18
1284,27,Puducherry,91304,81889,9415,2021-04-11 18:04:18
1285,28,Punjab,1593475,1447268,146207,2021-04-11 18:04:18
1286,29,Rajasthan,7816457,6796424,1020033,2021-04-11 18:04:18
1287,30,Sikkim,99824,84960,14864,2021-04-11 18:04:18
1288,31,Tamil Nadu,3225378,2861137,364241,2021-04-11 18:04:18
1289,32,Telangana,1803609,1514084,289525,2021-04-11 18:04:18
1290,33,Tripura,685187,597203,87984,2021-04-11 18:04:18
1291,34,Uttar Pradesh,7049253,5861903,1187350,2021-04-11 18:04:18
1292,35,Uttarakhand,1072020,901074,170946,2021-04-11 18:04:18
1293,36,West Bengal,6811403,5934187,877216,2021-04-11 18:04:18
1294,37,Daman and Diu,28442,25211,3231,2021-04-11 18:04:18
1295,1,Andaman and Nicobar Islands,34881,29269,5612,2021-04-12 18:04:01
1296,2,Andhra Pradesh,3357421,2849294,508127,2021-04-12 18:04:01
1297,3,Arunachal Pradesh,120356,90572,29784,2021-04-12 18:04:01
1298,4,Assam,1325005,1077160,247845,2021-04-12 18:04:01
1299,5,Bihar,3736593,3200087,536506,2021-04-12 18:04:01
1300,6,Chandigarh,110411,91323,19088,2021-04-12 18:04:01
1301,7,Chhattisgarh,3621104,3213868,407236,2021-04-12 18:04:01
1302,8,Dadra and Nagar Haveli,32395,26897,5498,2021-04-12 18:04:01
1303,9,Delhi,1936304,1573631,362673,2021-04-12 18:04:01
1304,10,Goa,164915,133218,31697,2021-04-12 18:04:01
1305,11,Gujarat,7794469,6728161,1066308,2021-04-12 18:04:01
1306,12,Haryana,2088556,1880838,207718,2021-04-12 18:04:01
1307,13,Himachal Pradesh,896907,789101,107806,2021-04-12 18:04:01
1308,14,Jammu and Kashmir,1159281,972307,186974,2021-04-12 18:04:01
1309,15,Jharkhand,2032563,1743653,288910,2021-04-12 18:04:01
1310,16,Karnataka,5587110,5011268,575842,2021-04-12 18:04:01
1311,17,Kerala,4650327,4131531,518796,2021-04-12 18:04:01
1312,18,Ladakh,66086,57794,8292,2021-04-12 18:04:01
1313,19,Lakshadweep,9317,7118,2199,2021-04-12 18:04:01
1314,20,Madhya Pradesh,5146921,4532842,614079,2021-04-12 18:04:01
1315,21,Maharashtra,9065412,8104767,960645,2021-04-12 18:04:01
1316,22,Manipur,116437,74284,42153,2021-04-12 18:04:01
1317,23,Meghalaya,124201,86596,37605,2021-04-12 18:04:01
1318,24,Mizoram,86215,64433,21782,2021-04-12 18:04:01
1319,25,Nagaland,94099,67680,26419,2021-04-12 18:04:01
1320,26,Odisha,3114881,2645828,469053,2021-04-12 18:04:01
1321,27,Puducherry,103647,93653,9994,2021-04-12 18:04:01
1322,28,Punjab,1684968,1530940,154028,2021-04-12 18:04:01
1323,29,Rajasthan,8008015,6957885,1050130,2021-04-12 18:04:01
1324,30,Sikkim,108044,92612,15432,2021-04-12 18:04:01
1325,31,Tamil Nadu,3374669,2979242,395427,2021-04-12 18:04:01
1326,32,Telangana,1930212,1631224,298988,2021-04-12 18:04:01
1327,33,Tripura,698249,607023,91226,2021-04-12 18:04:01
1328,34,Uttar Pradesh,7542374,6279128,1263246,2021-04-12 18:04:01
1329,35,Uttarakhand,1123179,942989,180190,2021-04-12 18:04:01
1330,36,West Bengal,7043419,6115206,928213,2021-04-12 18:04:01
1331,37,Daman and Diu,30119,26692,3427,2021-04-12 18:04:01
1332,1,Andaman and Nicobar Islands,41669,35938,5731,2021-04-13 18:02:25
1333,2,Andhra Pradesh,3364616,2854891,509725,2021-04-13 18:02:25
1334,3,Arunachal Pradesh,128290,97064,31226,2021-04-13 18:02:25
1335,4,Assam,1343288,1087701,255587,2021-04-13 18:02:25
1336,5,Bihar,3832145,3282974,549171,2021-04-13 18:02:25
1337,6,Chandigarh,114338,94350,19988,2021-04-13 18:02:25
1338,7,Chhattisgarh,3716184,3299793,416391,2021-04-13 18:02:25
1339,8,Dadra and Nagar Haveli,33293,27680,5613,2021-04-13 18:02:25
1340,9,Delhi,2005530,1630365,375165,2021-04-13 18:02:25
1341,10,Goa,169114,136627,32487,2021-04-13 18:02:25
1342,11,Gujarat,7987587,6874370,1113217,2021-04-13 18:02:25
1343,12,Haryana,2216863,1990943,225920,2021-04-13 18:02:25
1344,13,Himachal Pradesh,957677,845920,111757,2021-04-13 18:02:25
1345,14,Jammu and Kashmir,1189508,999245,190263,2021-04-13 18:02:25
1346,15,Jharkhand,2104965,1809374,295591,2021-04-13 18:02:25
1347,16,Karnataka,5636977,5055799,581178,2021-04-13 18:02:25
1348,17,Kerala,4824445,4278574,545871,2021-04-13 18:02:25
1349,18,Ladakh,67053,58475,8578,2021-04-13 18:02:25
1350,19,Lakshadweep,9829,7590,2239,2021-04-13 18:02:25
1351,20,Madhya Pradesh,5455553,4824379,631174,2021-04-13 18:02:25
1352,21,Maharashtra,9282062,8294447,987615,2021-04-13 18:02:25
1353,22,Manipur,118748,75954,42794,2021-04-13 18:02:25
1354,23,Meghalaya,130635,91865,38770,2021-04-13 18:02:25
1355,24,Mizoram,94007,70442,23565,2021-04-13 18:02:25
1356,25,Nagaland,100856,73653,27203,2021-04-13 18:02:25
1357,26,Odisha,3199892,2721292,478600,2021-04-13 18:02:25
1358,27,Puducherry,118210,107690,10520,2021-04-13 18:02:25
1359,28,Punjab,1748687,1590159,158528,2021-04-13 18:02:25
1360,29,Rajasthan,8157195,7078034,1079161,2021-04-13 18:02:25
1361,30,Sikkim,117582,101602,15980,2021-04-13 18:02:25
1362,31,Tamil Nadu,3504431,3086787,417644,2021-04-13 18:02:25
1363,32,Telangana,1955885,1655111,300774,2021-04-13 18:02:25
1364,33,Tripura,707017,613523,93494,2021-04-13 18:02:25
1365,34,Uttar Pradesh,7902927,6594188,1308739,2021-04-13 18:02:25
1366,35,Uttarakhand,1161385,974169,187216,2021-04-13 18:02:25
1367,36,West Bengal,7165838,6203077,962761,2021-04-13 18:02:25
1368,37,Daman and Diu,31100,27498,3602,2021-04-13 18:02:25
1369,1,Andaman and Nicobar Islands,47488,41657,5831,2021-04-14 18:02:38
1370,2,Andhra Pradesh,3476076,2949219,526857,2021-04-14 18:02:38
1371,3,Arunachal Pradesh,134063,102278,31785,2021-04-14 18:02:38
1372,4,Assam,1347263,1090264,256999,2021-04-14 18:02:38
1373,5,Bihar,3982019,3409850,572169,2021-04-14 18:02:38
1374,6,Chandigarh,117817,96961,20856,2021-04-14 18:02:38
1375,7,Chhattisgarh,3782091,3356542,425549,2021-04-14 18:02:38
1376,8,Dadra and Nagar Haveli,34068,28328,5740,2021-04-14 18:02:38
1377,9,Delhi,2076249,1688294,387955,2021-04-14 18:02:38
1378,10,Goa,178960,145283,33677,2021-04-14 18:02:38
1379,11,Gujarat,8125830,6973656,1152174,2021-04-14 18:02:38
1380,12,Haryana,2341098,2092734,248364,2021-04-14 18:02:38
1381,13,Himachal Pradesh,1002570,887595,114975,2021-04-14 18:02:38
1382,14,Jammu and Kashmir,1219735,1025813,193922,2021-04-14 18:02:38
1383,15,Jharkhand,2185999,1883781,302218,2021-04-14 18:02:38
1384,16,Karnataka,5733275,5135400,597875,2021-04-14 18:02:38
1385,17,Kerala,4847059,4297038,550021,2021-04-14 18:02:38
1386,18,Ladakh,67625,58734,8891,2021-04-14 18:02:38
1387,19,Lakshadweep,9939,7689,2250,2021-04-14 18:02:38
1388,20,Madhya Pradesh,5773285,5116650,656635,2021-04-14 18:02:38
1389,21,Maharashtra,9639568,8602137,1037431,2021-04-14 18:02:38
1390,22,Manipur,121451,77973,43478,2021-04-14 18:02:38
1391,23,Meghalaya,135184,95571,39613,2021-04-14 18:02:38
1392,24,Mizoram,103146,76933,26213,2021-04-14 18:02:38
1393,25,Nagaland,107809,79829,27980,2021-04-14 18:02:38
1394,26,Odisha,3271475,2780875,490600,2021-04-14 18:02:38
1395,27,Puducherry,127108,116350,10758,2021-04-14 18:02:38
1396,28,Punjab,1822877,1658039,164838,2021-04-14 18:02:38
1397,29,Rajasthan,8273039,7164920,1108119,2021-04-14 18:02:38
1398,30,Sikkim,124038,107328,16710,2021-04-14 18:02:38
1399,31,Tamil Nadu,3573846,3142911,430935,2021-04-14 18:02:38
1400,32,Telangana,2085234,1772576,312658,2021-04-14 18:02:38
1401,33,Tripura,709261,615185,94076,2021-04-14 18:02:38
1402,34,Uttar Pradesh,8199290,6858202,1341088,2021-04-14 18:02:38
1403,35,Uttarakhand,1189893,997023,192870,2021-04-14 18:02:38
1404,36,West Bengal,7257054,6267966,989088,2021-04-14 18:02:38
1405,37,Daman and Diu,32040,28263,3777,2021-04-14 18:02:38
1406,1,Andaman and Nicobar Islands,51868,45919,5949,2021-04-15 18:00:07
1407,2,Andhra Pradesh,4014717,3447031,567686,2021-04-15 18:00:07
1408,3,Arunachal Pradesh,136820,104531,32289,2021-04-15 18:00:07
1409,4,Assam,1348778,1091192,257586,2021-04-15 18:00:07
1410,5,Bihar,4085160,3494289,590871,2021-04-15 18:00:07
1411,6,Chandigarh,121933,99758,22175,2021-04-15 18:00:07
1412,7,Chhattisgarh,3823639,3389727,433912,2021-04-15 18:00:07
1413,8,Dadra and Nagar Haveli,34957,29040,5917,2021-04-15 18:00:07
1414,9,Delhi,2152513,1747467,405046,2021-04-15 18:00:07
1415,10,Goa,188304,151120,37184,2021-04-15 18:00:07
1416,11,Gujarat,8264495,7059796,1204699,2021-04-15 18:00:07
1417,12,Haryana,2395777,2133573,262204,2021-04-15 18:00:07
1418,13,Himachal Pradesh,1040754,921964,118790,2021-04-15 18:00:07
1419,14,Jammu and Kashmir,1263364,1061826,201538,2021-04-15 18:00:07
1420,15,Jharkhand,2225860,1917148,308712,2021-04-15 18:00:07
1421,16,Karnataka,5872018,5246423,625595,2021-04-15 18:00:07
1422,17,Kerala,5047601,4458025,589576,2021-04-15 18:00:07
1423,18,Ladakh,68195,58844,9351,2021-04-15 18:00:07
1424,19,Lakshadweep,10613,8304,2309,2021-04-15 18:00:07
1425,20,Madhya Pradesh,5931979,5251653,680326,2021-04-15 18:00:07
1426,21,Maharashtra,10012420,8907075,1105345,2021-04-15 18:00:07
1427,22,Manipur,123924,79276,44648,2021-04-15 18:00:07
1428,23,Meghalaya,140222,99193,41029,2021-04-15 18:00:07
1429,24,Mizoram,115125,86991,28134,2021-04-15 18:00:07
1430,25,Nagaland,112903,84009,28894,2021-04-15 18:00:07
1431,26,Odisha,3402213,2883674,518539,2021-04-15 18:00:07
1432,27,Puducherry,136957,125361,11596,2021-04-15 18:00:07
1433,28,Punjab,1904149,1729062,175087,2021-04-15 18:00:07
1434,29,Rajasthan,8389531,7246694,1142837,2021-04-15 18:00:07
1435,30,Sikkim,130638,112722,17916,2021-04-15 18:00:07
1436,31,Tamil Nadu,3753185,3279300,473885,2021-04-15 18:00:07
1437,32,Telangana,2245091,1917202,327889,2021-04-15 18:00:07
1438,33,Tripura,709354,615219,94135,2021-04-15 18:00:07
1439,34,Uttar Pradesh,8424970,7024155,1400815,2021-04-15 18:00:07
1440,35,Uttarakhand,1222996,1021105,201891,2021-04-15 18:00:07
1441,36,West Bengal,7281397,6283603,997794,2021-04-15 18:00:07
1442,37,Daman and Diu,32660,28685,3975,2021-04-15 18:00:07
1443,1,Andaman and Nicobar Islands,57473,51325,6148,2021-04-16 18:04:06
1444,2,Andhra Pradesh,4020395,3450095,570300,2021-04-16 18:04:06
1445,3,Arunachal Pradesh,141997,108115,33882,2021-04-16 18:04:06
1446,4,Assam,1357592,1096169,261423,2021-04-16 18:04:06
1447,5,Bihar,4139393,3536806,602587,2021-04-16 18:04:06
1448,6,Chandigarh,126459,102834,23625,2021-04-16 18:04:06
1449,7,Chhattisgarh,3887270,3440286,446984,2021-04-16 18:04:06
1450,8,Dadra and Nagar Haveli,35925,29816,6109,2021-04-16 18:04:06
1451,9,Delhi,2201236,1780788,420448,2021-04-16 18:04:06
1452,10,Goa,199373,159038,40335,2021-04-16 18:04:06
1453,11,Gujarat,8383482,7128145,1255337,2021-04-16 18:04:06
1454,12,Haryana,2467207,2184597,282610,2021-04-16 18:04:06
1455,13,Himachal Pradesh,1086628,960996,125632,2021-04-16 18:04:06
1456,14,Jammu and Kashmir,1304341,1095465,208876,2021-04-16 18:04:06
1457,15,Jharkhand,2263686,1947423,316263,2021-04-16 18:04:06
1458,16,Karnataka,6065219,5399735,665484,2021-04-16 18:04:06
1459,17,Kerala,5220038,4588870,631168,2021-04-16 18:04:06
1460,18,Ladakh,68666,58904,9762,2021-04-16 18:04:06
1461,19,Lakshadweep,10703,8369,2334,2021-04-16 18:04:06
1462,20,Madhya Pradesh,5983506,5289717,693789,2021-04-16 18:04:06
1463,21,Maharashtra,10366655,9189712,1176943,2021-04-16 18:04:06
1464,22,Manipur,126914,81282,45632,2021-04-16 18:04:06
1465,23,Meghalaya,144904,102928,41976,2021-04-16 18:04:06
1466,24,Mizoram,127674,98766,28908,2021-04-16 18:04:06
1467,25,Nagaland,116714,87475,29239,2021-04-16 18:04:06
1468,26,Odisha,3492482,2954188,538294,2021-04-16 18:04:06
1469,27,Puducherry,145525,133058,12467,2021-04-16 18:04:06
1470,28,Punjab,1995399,1809331,186068,2021-04-16 18:04:06
1471,29,Rajasthan,8533007,7341099,1191908,2021-04-16 18:04:06
1472,30,Sikkim,137083,117854,19229,2021-04-16 18:04:06
1473,31,Tamil Nadu,3929227,3411662,517565,2021-04-16 18:04:06
1474,32,Telangana,2411007,2067769,343238,2021-04-16 18:04:06
1475,33,Tripura,724717,622757,101960,2021-04-16 18:04:06
1476,34,Uttar Pradesh,8664374,7187304,1477070,2021-04-16 18:04:06
1477,35,Uttarakhand,1270169,1053960,216209,2021-04-16 18:04:06
1478,36,West Bengal,7415193,6361377,1053816,2021-04-16 18:04:06
1479,37,Daman and Diu,33675,29420,4255,2021-04-16 18:04:06
1480,1,Andaman and Nicobar Islands,61966,55626,6340,2021-04-17 18:01:05
1481,2,Andhra Pradesh,4023798,3451839,571959,2021-04-17 18:01:05
1482,3,Arunachal Pradesh,145834,111131,34703,2021-04-17 18:01:05
1483,4,Assam,1378003,1107542,270461,2021-04-17 18:01:05
1484,5,Bihar,4265452,3632991,632461,2021-04-17 18:01:05
1485,6,Chandigarh,130459,105664,24795,2021-04-17 18:01:05
1486,7,Chhattisgarh,3995001,3524685,470316,2021-04-17 18:01:05
1487,8,Dadra and Nagar Haveli,36565,30298,6267,2021-04-17 18:01:05
1488,9,Delhi,2268576,1835028,433548,2021-04-17 18:01:05
1489,10,Goa,210579,167373,43206,2021-04-17 18:01:05
1490,11,Gujarat,8531152,7213244,1317908,2021-04-17 18:01:05
1491,12,Haryana,2520001,2222286,297715,2021-04-17 18:01:05
1492,13,Himachal Pradesh,1123016,991880,131136,2021-04-17 18:01:05
1493,14,Jammu and Kashmir,1345210,1128687,216523,2021-04-17 18:01:05
1494,15,Jharkhand,2310990,1985587,325403,2021-04-17 18:01:05
1495,16,Karnataka,6323195,5599130,724065,2021-04-17 18:01:05
1496,17,Kerala,5369495,4703535,665960,2021-04-17 18:01:05
1497,18,Ladakh,69462,59001,10461,2021-04-17 18:01:05
1498,19,Lakshadweep,11316,8933,2383,2021-04-17 18:01:05
1499,20,Madhya Pradesh,6149417,5422096,727321,2021-04-17 18:01:05
1500,21,Maharashtra,10608522,9370089,1238433,2021-04-17 18:01:05
1501,22,Manipur,130372,83454,46918,2021-04-17 18:01:05
1502,23,Meghalaya,146851,104420,42431,2021-04-17 18:01:05
1503,24,Mizoram,132923,103446,29477,2021-04-17 18:01:05
1504,25,Nagaland,118704,89376,29328,2021-04-17 18:01:05
1505,26,Odisha,3546653,2994248,552405,2021-04-17 18:01:05
1506,27,Puducherry,151410,138107,13303,2021-04-17 18:01:05
1507,28,Punjab,2077358,1879659,197699,2021-04-17 18:01:05
1508,29,Rajasthan,8672079,7435925,1236154,2021-04-17 18:01:05
1509,30,Sikkim,141277,121080,20197,2021-04-17 18:01:05
1510,31,Tamil Nadu,4030820,3475186,555634,2021-04-17 18:01:05
1511,32,Telangana,2558247,2202260,355987,2021-04-17 18:01:05
1512,33,Tripura,740132,630474,109658,2021-04-17 18:01:05
1513,34,Uttar Pradesh,8823765,7298091,1525674,2021-04-17 18:01:05
1514,35,Uttarakhand,1312944,1083750,229194,2021-04-17 18:01:05
1515,36,West Bengal,7539874,6433400,1106474,2021-04-17 18:01:05
1516,37,Daman and Diu,34636,30210,4426,2021-04-17 18:01:05
1517,1,Andaman and Nicobar Islands,64910,58342,6568,2021-04-18 18:03:16
1518,2,Andhra Pradesh,4028601,3454724,573877,2021-04-18 18:03:16
1519,3,Arunachal Pradesh,147179,112028,35151,2021-04-18 18:03:16
1520,4,Assam,1388596,1114488,274108,2021-04-18 18:03:16
1521,5,Bihar,4354379,3704198,650181,2021-04-18 18:03:16
1522,6,Chandigarh,132465,107112,25353,2021-04-18 18:03:16
1523,7,Chhattisgarh,4072529,3588251,484278,2021-04-18 18:03:16
1524,8,Dadra and Nagar Haveli,36777,30449,6328,2021-04-18 18:03:16
1525,9,Delhi,2316537,1875653,440884,2021-04-18 18:03:16
1526,10,Goa,216796,172731,44065,2021-04-18 18:03:16
1527,11,Gujarat,8627055,7268392,1358663,2021-04-18 18:03:16
1528,12,Haryana,2551566,2246653,304913,2021-04-18 18:03:16
1529,13,Himachal Pradesh,1134319,1001085,133234,2021-04-18 18:03:16
1530,14,Jammu and Kashmir,1375700,1154078,221622,2021-04-18 18:03:16
1531,15,Jharkhand,2347087,2013415,333672,2021-04-18 18:03:16
1532,16,Karnataka,6423321,5678466,744855,2021-04-18 18:03:16
1533,17,Kerala,5410347,4737840,672507,2021-04-18 18:03:16
1534,18,Ladakh,69505,59034,10471,2021-04-18 18:03:16
1535,19,Lakshadweep,11475,9027,2448,2021-04-18 18:03:16
1536,20,Madhya Pradesh,6177274,5443878,733396,2021-04-18 18:03:16
1537,21,Maharashtra,10738711,9475269,1263442,2021-04-18 18:03:16
1538,22,Manipur,131354,84330,47024,2021-04-18 18:03:16
1539,23,Meghalaya,146929,104495,42434,2021-04-18 18:03:16
1540,24,Mizoram,133602,104113,29489,2021-04-18 18:03:16
1541,25,Nagaland,119682,90339,29343,2021-04-18 18:03:16
1542,26,Odisha,3597290,3031465,565825,2021-04-18 18:03:16
1543,27,Puducherry,153117,139548,13569,2021-04-18 18:03:16
1544,28,Punjab,2128502,1924580,203922,2021-04-18 18:03:16
1545,29,Rajasthan,8827380,7535736,1291644,2021-04-18 18:03:16
1546,30,Sikkim,142870,122457,20413,2021-04-18 18:03:16
1547,31,Tamil Nadu,4053740,3487387,566353,2021-04-18 18:03:16
1548,32,Telangana,2567626,2210057,357569,2021-04-18 18:03:16
1549,33,Tripura,744798,632784,112014,2021-04-18 18:03:16
1550,34,Uttar Pradesh,8827549,7300340,1527209,2021-04-18 18:03:16
1551,35,Uttarakhand,1316717,1086804,229913,2021-04-18 18:03:16
1552,36,West Bengal,7563000,6448375,1114625,2021-04-18 18:03:16
1553,37,Daman and Diu,34937,30437,4500,2021-04-18 18:03:16
1554,1,Andaman and Nicobar Islands,68646,61626,7020,2021-04-19 18:02:33
1555,2,Andhra Pradesh,4144314,3555101,589213,2021-04-19 18:02:33
1556,3,Arunachal Pradesh,154400,117031,37369,2021-04-19 18:02:33
1557,4,Assam,1463965,1159413,304552,2021-04-19 18:02:33
1558,5,Bihar,4475781,3792877,682904,2021-04-19 18:02:33
1559,6,Chandigarh,136944,109874,27070,2021-04-19 18:02:33
1560,7,Chhattisgarh,4146020,3644219,501801,2021-04-19 18:02:33
1561,8,Dadra and Nagar Haveli,37329,30824,6505,2021-04-19 18:02:33
1562,9,Delhi,2374809,1913837,460972,2021-04-19 18:02:33
1563,10,Goa,225318,178547,46771,2021-04-19 18:02:33
1564,11,Gujarat,8770505,7336062,1434443,2021-04-19 18:02:33
1565,12,Haryana,2632423,2297353,335070,2021-04-19 18:02:33
1566,13,Himachal Pradesh,1172062,1031578,140484,2021-04-19 18:02:33
1567,14,Jammu and Kashmir,1436562,1201901,234661,2021-04-19 18:02:33
1568,15,Jharkhand,2374473,2031052,343421,2021-04-19 18:02:33
1569,16,Karnataka,6637434,5826711,810723,2021-04-19 18:02:33
1570,17,Kerala,5559847,4841128,718719,2021-04-19 18:02:33
1571,18,Ladakh,71858,59196,12662,2021-04-19 18:02:33
1572,19,Lakshadweep,11583,9107,2476,2021-04-19 18:02:33
1573,20,Madhya Pradesh,6329418,5555343,774075,2021-04-19 18:02:33
1574,21,Maharashtra,11085099,9727947,1357152,2021-04-19 18:02:33
1575,22,Manipur,135897,87836,48061,2021-04-19 18:02:33
1576,23,Meghalaya,151779,107786,43993,2021-04-19 18:02:33
1577,24,Mizoram,142549,111806,30743,2021-04-19 18:02:33
1578,25,Nagaland,127115,96722,30393,2021-04-19 18:02:33
1579,26,Odisha,3719322,3115103,604219,2021-04-19 18:02:33
1580,27,Puducherry,155828,141208,14620,2021-04-19 18:02:33
1581,28,Punjab,2220770,2002445,218325,2021-04-19 18:02:33
1582,29,Rajasthan,9087113,7695443,1391670,2021-04-19 18:02:33
1583,30,Sikkim,147761,125631,22130,2021-04-19 18:02:33
1584,31,Tamil Nadu,4129529,3520479,609050,2021-04-19 18:02:33
1585,32,Telangana,2729139,2350432,378707,2021-04-19 18:02:33
1586,33,Tripura,765574,640183,125391,2021-04-19 18:02:33
1587,34,Uttar Pradesh,8995960,7397200,1598760,2021-04-19 18:02:33
1588,35,Uttarakhand,1370874,1121476,249398,2021-04-19 18:02:33
1589,36,West Bengal,7764008,6546724,1217284,2021-04-19 18:02:33
1590,37,Daman and Diu,35604,30890,4714,2021-04-19 18:02:33
1591,1,Andaman and Nicobar Islands,71851,64248,7603,2021-04-20 18:03:45
1592,2,Andhra Pradesh,4320130,3654243,665887,2021-04-20 18:03:45
1593,3,Arunachal Pradesh,159669,121012,38657,2021-04-20 18:03:45
1594,4,Assam,1551494,1217908,333586,2021-04-20 18:03:45
1595,5,Bihar,4576312,3865367,710945,2021-04-20 18:03:45
1596,6,Chandigarh,141346,112435,28911,2021-04-20 18:03:45
1597,7,Chhattisgarh,4199454,3683792,515662,2021-04-20 18:03:45
1598,8,Dadra and Nagar Haveli,37827,31175,6652,2021-04-20 18:03:45
1599,9,Delhi,2425071,1949127,475944,2021-04-20 18:03:45
1600,10,Goa,235329,185400,49929,2021-04-20 18:03:45
1601,11,Gujarat,8922886,7404568,1518318,2021-04-20 18:03:45
1602,12,Haryana,2695529,2338114,357415,2021-04-20 18:03:45
1603,13,Himachal Pradesh,1218871,1069491,149380,2021-04-20 18:03:45
1604,14,Jammu and Kashmir,1496025,1249715,246310,2021-04-20 18:03:45
1605,15,Jharkhand,2408782,2053005,355777,2021-04-20 18:03:45
1606,16,Karnataka,6840596,5965413,875183,2021-04-20 18:03:45
1607,17,Kerala,5766447,4976383,790064,2021-04-20 18:03:45
1608,18,Ladakh,74678,59346,15332,2021-04-20 18:03:45
1609,19,Lakshadweep,11800,9234,2566,2021-04-20 18:03:45
1610,20,Madhya Pradesh,6366282,5580837,785445,2021-04-20 18:03:45
1611,21,Maharashtra,11361877,9917979,1443898,2021-04-20 18:03:45
1612,22,Manipur,140209,91168,49041,2021-04-20 18:03:45
1613,23,Meghalaya,157524,112183,45341,2021-04-20 18:03:45
1614,24,Mizoram,151460,119209,32251,2021-04-20 18:03:45
1615,25,Nagaland,134250,102890,31360,2021-04-20 18:03:45
1616,26,Odisha,3813631,3178002,635629,2021-04-20 18:03:45
1617,27,Puducherry,157685,142280,15405,2021-04-20 18:03:45
1618,28,Punjab,2302826,2070240,232586,2021-04-20 18:03:45
1619,29,Rajasthan,9298337,7822430,1475907,2021-04-20 18:03:45
1620,30,Sikkim,152249,128523,23726,2021-04-20 18:03:45
1621,31,Tamil Nadu,4185180,3542332,642848,2021-04-20 18:03:45
1622,32,Telangana,2861374,2462686,398688,2021-04-20 18:03:45
1623,33,Tripura,784985,647134,137851,2021-04-20 18:03:45
1624,34,Uttar Pradesh,9179719,7502571,1677148,2021-04-20 18:03:45
1625,35,Uttarakhand,1416547,1151105,265442,2021-04-20 18:03:45
1626,36,West Bengal,7984214,6664036,1320178,2021-04-20 18:03:45
1627,37,Daman and Diu,36502,31538,4964,2021-04-20 18:03:45
1628,1,Andaman and Nicobar Islands,74022,66218,7804,2021-04-21 18:03:29
1629,2,Andhra Pradesh,4358798,3674334,684464,2021-04-21 18:03:29
1630,3,Arunachal Pradesh,164144,124656,39488,2021-04-21 18:03:29
1631,4,Assam,1603667,1255920,347747,2021-04-21 18:03:29
1632,5,Bihar,4652633,3920449,732184,2021-04-21 18:03:29
1633,6,Chandigarh,145216,115022,30194,2021-04-21 18:03:29
1634,7,Chhattisgarh,4236714,3710052,526662,2021-04-21 18:03:29
1635,8,Dadra and Nagar Haveli,38084,31337,6747,2021-04-21 18:03:29
1636,9,Delhi,2478499,1987578,490921,2021-04-21 18:03:29
1637,10,Goa,243085,190728,52357,2021-04-21 18:03:29
1638,11,Gujarat,9030006,7453573,1576433,2021-04-21 18:03:29
1639,12,Haryana,2730614,2361096,369518,2021-04-21 18:03:29
1640,13,Himachal Pradesh,1240770,1087899,152871,2021-04-21 18:03:29
1641,14,Jammu and Kashmir,1540260,1286420,253840,2021-04-21 18:03:29
1642,15,Jharkhand,2433964,2068874,365090,2021-04-21 18:03:29
1643,16,Karnataka,7009935,6080100,929835,2021-04-21 18:03:29
1644,17,Kerala,5874890,5045328,829562,2021-04-21 18:03:29
1645,18,Ladakh,77528,59462,18066,2021-04-21 18:03:29
1646,19,Lakshadweep,12024,9426,2598,2021-04-21 18:03:29
1647,20,Madhya Pradesh,6386871,5590820,796051,2021-04-21 18:03:29
1648,21,Maharashtra,11685542,10151893,1533649,2021-04-21 18:03:29
1649,22,Manipur,145507,95565,49942,2021-04-21 18:03:29
1650,23,Meghalaya,161529,115244,46285,2021-04-21 18:03:29
1651,24,Mizoram,159093,125357,33736,2021-04-21 18:03:29
1652,25,Nagaland,140841,108606,32235,2021-04-21 18:03:29
1653,26,Odisha,3906795,3242935,663860,2021-04-21 18:03:29
1654,27,Puducherry,160252,143899,16353,2021-04-21 18:03:29
1655,28,Punjab,2360205,2115787,244418,2021-04-21 18:03:29
1656,29,Rajasthan,9464073,7918740,1545333,2021-04-21 18:03:29
1657,30,Sikkim,153627,129482,24145,2021-04-21 18:03:29
1658,31,Tamil Nadu,4240779,3563258,677521,2021-04-21 18:03:29
1659,32,Telangana,2975567,2558685,416882,2021-04-21 18:03:29
1660,33,Tripura,791475,650172,141303,2021-04-21 18:03:29
1661,34,Uttar Pradesh,9304171,7582470,1721701,2021-04-21 18:03:29
1662,35,Uttarakhand,1451483,1174795,276688,2021-04-21 18:03:29
1663,36,West Bengal,8159567,6758343,1401224,2021-04-21 18:03:29
1664,37,Daman and Diu,36905,31827,5078,2021-04-21 18:03:29
1665,1,Andaman and Nicobar Islands,75895,67716,8179,2021-04-22 17:30:19
1666,2,Andhra Pradesh,4651134,3691592,959542,2021-04-22 17:30:19
1667,3,Arunachal Pradesh,170798,129662,41136,2021-04-22 17:30:19
1668,4,Assam,1672016,1305052,366964,2021-04-22 17:30:19
1669,5,Bihar,4745251,3981719,763532,2021-04-22 17:30:19
1670,6,Chandigarh,150327,118075,32252,2021-04-22 17:30:19
1671,7,Chhattisgarh,4294225,3750633,543592,2021-04-22 17:30:19
1672,8,Dadra and Nagar Haveli,38403,31518,6885,2021-04-22 17:30:19
1673,9,Delhi,2545543,2034419,511124,2021-04-22 17:30:19
1674,10,Goa,251133,196534,54599,2021-04-22 17:30:19
1675,11,Gujarat,9166424,7508661,1657763,2021-04-22 17:30:19
1676,12,Haryana,2780553,2393142,387411,2021-04-22 17:30:19
1677,13,Himachal Pradesh,1288124,1126165,161959,2021-04-22 17:30:19
1678,14,Jammu and Kashmir,1589968,1324876,265092,2021-04-22 17:30:19
1679,15,Jharkhand,2455211,2081514,373697,2021-04-22 17:30:19
1680,16,Karnataka,7216349,6209985,1006364,2021-04-22 17:30:19
1681,17,Kerala,6021209,5132032,889177,2021-04-22 17:30:19
1682,18,Ladakh,79752,59617,20135,2021-04-22 17:30:19
1683,19,Lakshadweep,12144,9527,2617,2021-04-22 17:30:19
1684,20,Madhya Pradesh,6532332,5679413,852919,2021-04-22 17:30:19
1685,21,Maharashtra,12052353,10399785,1652568,2021-04-22 17:30:19
1686,22,Manipur,149648,98619,51029,2021-04-22 17:30:19
1687,23,Meghalaya,170057,121901,48156,2021-04-22 17:30:19
1688,24,Mizoram,170218,134729,35489,2021-04-22 17:30:19
1689,25,Nagaland,147141,114083,33058,2021-04-22 17:30:19
1690,26,Odisha,3981790,3293569,688221,2021-04-22 17:30:19
1691,27,Puducherry,162692,145335,17357,2021-04-22 17:30:19
1692,28,Punjab,2415251,2159121,256130,2021-04-22 17:30:19
1693,29,Rajasthan,9623404,8013815,1609589,2021-04-22 17:30:19
1694,30,Sikkim,158034,131292,26742,2021-04-22 17:30:19
1695,31,Tamil Nadu,4329622,3590851,738771,2021-04-22 17:30:19
1696,32,Telangana,3160351,2716830,443521,2021-04-22 17:30:19
1697,33,Tripura,801911,653693,148218,2021-04-22 17:30:19
1698,34,Uttar Pradesh,9466589,7678224,1788365,2021-04-22 17:30:19
1699,35,Uttarakhand,1497950,1204589,293361,2021-04-22 17:30:19
1700,36,West Bengal,8314866,6842303,1472563,2021-04-22 17:30:19
1701,37,Daman and Diu,37532,32226,5306,2021-04-22 17:30:19
1702,1,Andaman and Nicobar Islands,78104,69581,8523,2021-04-23 18:02:41
1703,2,Andhra Pradesh,4850668,3791582,1059086,2021-04-23 18:02:41
1704,3,Arunachal Pradesh,178075,135038,43037,2021-04-23 18:02:41
1705,4,Assam,1729413,1348987,380426,2021-04-23 18:02:41
1706,5,Bihar,4828872,4038245,790627,2021-04-23 18:02:41
1707,6,Chandigarh,155314,121027,34287,2021-04-23 18:02:41
1708,7,Chhattisgarh,4348352,3788338,560014,2021-04-23 18:02:41
1709,8,Dadra and Nagar Haveli,38775,31742,7033,2021-04-23 18:02:41
1710,9,Delhi,2580662,2054865,525797,2021-04-23 18:02:41
1711,10,Goa,259136,202155,56981,2021-04-23 18:02:41
1712,11,Gujarat,9309461,7569957,1739504,2021-04-23 18:02:41
1713,12,Haryana,2852295,2437128,415167,2021-04-23 18:02:41
1714,13,Himachal Pradesh,1332535,1160923,171612,2021-04-23 18:02:41
1715,14,Jammu and Kashmir,1654113,1376866,277247,2021-04-23 18:02:41
1716,15,Jharkhand,2485112,2099106,386006,2021-04-23 18:02:41
1717,16,Karnataka,7446450,6360448,1086002,2021-04-23 18:02:41
1718,17,Kerala,6142894,5200082,942812,2021-04-23 18:02:41
1719,18,Ladakh,82343,59742,22601,2021-04-23 18:02:41
1720,19,Lakshadweep,12268,9619,2649,2021-04-23 18:02:41
1721,20,Madhya Pradesh,6575051,5706065,868986,2021-04-23 18:02:41
1722,21,Maharashtra,12362513,10603808,1758705,2021-04-23 18:02:41
1723,22,Manipur,152045,100551,51494,2021-04-23 18:02:41
1724,23,Meghalaya,178766,129164,49602,2021-04-23 18:02:41
1725,24,Mizoram,183298,146213,37085,2021-04-23 18:02:41
1726,25,Nagaland,149821,116182,33639,2021-04-23 18:02:41
1727,26,Odisha,4079492,3358108,721384,2021-04-23 18:02:41
1728,27,Puducherry,165527,147011,18516,2021-04-23 18:02:41
1729,28,Punjab,2507457,2232197,275260,2021-04-23 18:02:41
1730,29,Rajasthan,9769345,8099064,1670281,2021-04-23 18:02:41
1731,30,Sikkim,163024,133215,29809,2021-04-23 18:02:41
1732,31,Tamil Nadu,4433149,3623871,809278,2021-04-23 18:02:41
1733,32,Telangana,3377819,2911627,466192,2021-04-23 18:02:41
1734,33,Tripura,828843,661078,167765,2021-04-23 18:02:41
1735,34,Uttar Pradesh,9630143,7776828,1853315,2021-04-23 18:02:41
1736,35,Uttarakhand,1538890,1232608,306282,2021-04-23 18:02:41
1737,36,West Bengal,8524621,6946008,1578613,2021-04-23 18:02:41
1738,37,Daman and Diu,38185,32643,5542,2021-04-23 18:02:41
1739,1,Andaman and Nicobar Islands,79935,71103,8832,2021-04-24 18:04:54
1740,2,Andhra Pradesh,4957699,3862688,1095011,2021-04-24 18:04:54
1741,3,Arunachal Pradesh,182624,138458,44166,2021-04-24 18:04:54
1742,4,Assam,1773648,1384328,389320,2021-04-24 18:04:54
1743,5,Bihar,4907232,4091657,815575,2021-04-24 18:04:54
1744,6,Chandigarh,160707,124724,35983,2021-04-24 18:04:54
1745,7,Chhattisgarh,4393249,3817614,575635,2021-04-24 18:04:54
1746,8,Dadra and Nagar Haveli,39066,31898,7168,2021-04-24 18:04:54
1747,9,Delhi,2650268,2102801,547467,2021-04-24 18:04:54
1748,10,Goa,268173,208883,59290,2021-04-24 18:04:54
1749,11,Gujarat,9458161,7634695,1823466,2021-04-24 18:04:54
1750,12,Haryana,2914850,2477260,437590,2021-04-24 18:04:54
1751,13,Himachal Pradesh,1371795,1192591,179204,2021-04-24 18:04:54
1752,14,Jammu and Kashmir,1721631,1431429,290202,2021-04-24 18:04:54
1753,15,Jharkhand,2511609,2114381,397228,2021-04-24 18:04:54
1754,16,Karnataka,7580691,6453823,1126868,2021-04-24 18:04:54
1755,17,Kerala,6340622,5312978,1027644,2021-04-24 18:04:54
1756,18,Ladakh,84367,59908,24459,2021-04-24 18:04:54
1757,19,Lakshadweep,12468,9767,2701,2021-04-24 18:04:54
1758,20,Madhya Pradesh,6684061,5765678,918383,2021-04-24 18:04:54
1759,21,Maharashtra,12585854,10739442,1846412,2021-04-24 18:04:54
1760,22,Manipur,157863,105420,52443,2021-04-24 18:04:54
1761,23,Meghalaya,183869,133731,50138,2021-04-24 18:04:54
1762,24,Mizoram,188391,150507,37884,2021-04-24 18:04:54
1763,25,Nagaland,150758,116983,33775,2021-04-24 18:04:54
1764,26,Odisha,4083320,3360367,722953,2021-04-24 18:04:54
1765,27,Puducherry,167635,148245,19390,2021-04-24 18:04:54
1766,28,Punjab,2616000,2319164,296836,2021-04-24 18:04:54
1767,29,Rajasthan,9940968,8197744,1743224,2021-04-24 18:04:54
1768,30,Sikkim,165663,134363,31300,2021-04-24 18:04:54
1769,31,Tamil Nadu,4534130,3661066,873064,2021-04-24 18:04:54
1770,32,Telangana,3563657,3073315,490342,2021-04-24 18:04:54
1771,33,Tripura,852624,667701,184923,2021-04-24 18:04:54
1772,34,Uttar Pradesh,9769106,7863206,1905900,2021-04-24 18:04:54
1773,35,Uttarakhand,1577797,1258767,319030,2021-04-24 18:04:54
1774,36,West Bengal,8671140,7024254,1646886,2021-04-24 18:04:54
1775,37,Daman and Diu,38770,33041,5729,2021-04-24 18:04:54
1776,1,Andaman and Nicobar Islands,80971,71936,9035,2021-04-25 18:03:45
1777,2,Andhra Pradesh,4965175,3866359,1098816,2021-04-25 18:03:45
1778,3,Arunachal Pradesh,183765,139305,44460,2021-04-25 18:03:45
1779,4,Assam,1787615,1395959,391656,2021-04-25 18:03:45
1780,5,Bihar,4967816,4133536,834280,2021-04-25 18:03:45
1781,6,Chandigarh,164687,127563,37124,2021-04-25 18:03:45
1782,7,Chhattisgarh,4426981,3838555,588426,2021-04-25 18:03:45
1783,8,Dadra and Nagar Haveli,39158,31932,7226,2021-04-25 18:03:45
1784,9,Delhi,2693897,2134690,559207,2021-04-25 18:03:45
1785,10,Goa,272734,212475,60259,2021-04-25 18:03:45
1786,11,Gujarat,9542213,7673387,1868826,2021-04-25 18:03:45
1787,12,Haryana,2944556,2498813,445743,2021-04-25 18:03:45
1788,13,Himachal Pradesh,1383973,1202185,181788,2021-04-25 18:03:45
1789,14,Jammu and Kashmir,1764593,1468164,296429,2021-04-25 18:03:45
1790,15,Jharkhand,2522737,2120745,401992,2021-04-25 18:03:45
1791,16,Karnataka,7651888,6501164,1150724,2021-04-25 18:03:45
1792,17,Kerala,6358811,5325077,1033734,2021-04-25 18:03:45
1793,18,Ladakh,84695,59908,24787,2021-04-25 18:03:45
1794,19,Lakshadweep,12636,9887,2749,2021-04-25 18:03:45
1795,20,Madhya Pradesh,6697984,5773242,924742,2021-04-25 18:03:45
1796,21,Maharashtra,12690974,10810218,1880756,2021-04-25 18:03:45
1797,22,Manipur,160040,107394,52646,2021-04-25 18:03:45
1798,23,Meghalaya,185801,135605,50196,2021-04-25 18:03:45
1799,24,Mizoram,188956,151042,37914,2021-04-25 18:03:45
1800,25,Nagaland,151205,117410,33795,2021-04-25 18:03:45
1801,26,Odisha,4084774,3361351,723423,2021-04-25 18:03:45
1802,27,Puducherry,168166,148548,19618,2021-04-25 18:03:45
1803,28,Punjab,2680379,2372724,307655,2021-04-25 18:03:45
1804,29,Rajasthan,10051950,8265953,1785997,2021-04-25 18:03:45
1805,30,Sikkim,166091,134705,31386,2021-04-25 18:03:45
1806,31,Tamil Nadu,4547163,3665870,881293,2021-04-25 18:03:45
1807,32,Telangana,3624651,3126201,498450,2021-04-25 18:03:45
1808,33,Tripura,859721,670205,189516,2021-04-25 18:03:45
1809,34,Uttar Pradesh,9774084,7865917,1908167,2021-04-25 18:03:45
1810,35,Uttarakhand,1594343,1270520,323823,2021-04-25 18:03:45
1811,36,West Bengal,8701540,7041277,1660263,2021-04-25 18:03:45
1812,37,Daman and Diu,39009,33178,5831,2021-04-25 18:03:45
1813,1,Andaman and Nicobar Islands,82621,73299,9322,2021-04-26 18:07:10
1814,2,Andhra Pradesh,5249365,4056848,1192517,2021-04-26 18:07:10
1815,3,Arunachal Pradesh,189915,143715,46200,2021-04-26 18:07:10
1816,4,Assam,1866929,1450422,416507,2021-04-26 18:07:10
1817,5,Bihar,5070126,4198978,871148,2021-04-26 18:07:10
1818,6,Chandigarh,169995,130798,39197,2021-04-26 18:07:10
1819,7,Chhattisgarh,4466020,3860254,605766,2021-04-26 18:07:10
1820,8,Dadra and Nagar Haveli,39464,32082,7382,2021-04-26 18:07:10
1821,9,Delhi,2750601,2170110,580491,2021-04-26 18:07:10
1822,10,Goa,281557,219125,62432,2021-04-26 18:07:10
1823,11,Gujarat,9702757,7737046,1965711,2021-04-26 18:07:10
1824,12,Haryana,2992405,2528950,463455,2021-04-26 18:07:10
1825,13,Himachal Pradesh,1425957,1232700,193257,2021-04-26 18:07:10
1826,14,Jammu and Kashmir,1840065,1528358,311707,2021-04-26 18:07:10
1827,15,Jharkhand,2547160,2134190,412970,2021-04-26 18:07:10
1828,16,Karnataka,7848893,6616883,1232010,2021-04-26 18:07:10
1829,17,Kerala,6499196,5405589,1093607,2021-04-26 18:07:10
1830,18,Ladakh,87779,60090,27689,2021-04-26 18:07:10
1831,19,Lakshadweep,12753,9973,2780,2021-04-26 18:07:10
1832,20,Madhya Pradesh,6773097,5804388,968709,2021-04-26 18:07:10
1833,21,Maharashtra,13213253,11134601,2078652,2021-04-26 18:07:10
1834,22,Manipur,169624,115742,53882,2021-04-26 18:07:10
1835,23,Meghalaya,197934,146101,51833,2021-04-26 18:07:10
1836,24,Mizoram,198729,158926,39803,2021-04-26 18:07:10
1837,25,Nagaland,156512,121068,35444,2021-04-26 18:07:10
1838,26,Odisha,4162248,3407231,755017,2021-04-26 18:07:10
1839,27,Puducherry,170706,149598,21108,2021-04-26 18:07:10
1840,28,Punjab,2765403,2437949,327454,2021-04-26 18:07:10
1841,29,Rajasthan,10220551,8362998,1857553,2021-04-26 18:07:10
1842,30,Sikkim,169915,136228,33687,2021-04-26 18:07:10
1843,31,Tamil Nadu,4659574,3699564,960010,2021-04-26 18:07:10
1844,32,Telangana,3827551,3299383,528168,2021-04-26 18:07:10
1845,33,Tripura,899514,680051,219463,2021-04-26 18:07:10
1846,34,Uttar Pradesh,9922286,7951020,1971266,2021-04-26 18:07:10
1847,35,Uttarakhand,1640450,1299238,341212,2021-04-26 18:07:10
1848,36,West Bengal,8948475,7149206,1799269,2021-04-26 18:07:10
1849,37,Daman and Diu,39633,33469,6164,2021-04-26 18:07:10
1850,1,Andaman and Nicobar Islands,100571,90454,10117,2021-04-27 18:06:48
1851,2,Andhra Pradesh,6177693,4904030,1273663,2021-04-27 18:06:48
1852,3,Arunachal Pradesh,222085,172178,49907,2021-04-27 18:06:48
1853,4,Assam,2192325,1728642,463683,2021-04-27 18:06:48
1854,5,Bihar,6661790,5686449,975341,2021-04-27 18:06:48
1855,6,Chandigarh,190041,148026,42015,2021-04-27 18:06:48
1856,7,Chhattisgarh,5438541,4791314,647227,2021-04-27 18:06:48
1857,8,Dadra and Nagar Haveli,46553,38690,7863,2021-04-27 18:06:48
1858,9,Delhi,3114832,2495676,619156,2021-04-27 18:06:48
1859,10,Goa,323213,256196,67017,2021-04-27 18:06:48
1860,11,Gujarat,11901253,9718868,2182385,2021-04-27 18:06:48
1861,12,Haryana,3634905,3122680,512225,2021-04-27 18:06:48
1862,13,Himachal Pradesh,1644453,1434382,210071,2021-04-27 18:06:48
1863,14,Jammu and Kashmir,2186894,1848389,338505,2021-04-27 18:06:48
1864,15,Jharkhand,3029124,2589148,439976,2021-04-27 18:06:48
1865,16,Karnataka,9088000,7750770,1337230,2021-04-27 18:06:48
1866,17,Kerala,7106942,5947361,1159581,2021-04-27 18:06:48
1867,18,Ladakh,103717,73508,30209,2021-04-27 18:06:48
1868,19,Lakshadweep,21928,17998,3930,2021-04-27 18:06:48
1869,20,Madhya Pradesh,8010474,6996487,1013987,2021-04-27 18:06:48
1870,21,Maharashtra,15321730,13030894,2290836,2021-04-27 18:06:48
1871,22,Manipur,200674,142612,58062,2021-04-27 18:06:48
1872,23,Meghalaya,242572,187409,55163,2021-04-27 18:06:48
1873,24,Mizoram,235041,191344,43697,2021-04-27 18:06:48
1874,25,Nagaland,183201,145555,37646,2021-04-27 18:06:48
1875,26,Odisha,5691740,4837588,854152,2021-04-27 18:06:48
1876,27,Puducherry,187897,164814,23083,2021-04-27 18:06:48
1877,28,Punjab,3131430,2779190,352240,2021-04-27 18:06:48
1878,29,Rajasthan,12659945,10578840,2081105,2021-04-27 18:06:48
1879,30,Sikkim,193834,157168,36666,2021-04-27 18:06:48
1880,31,Tamil Nadu,5624732,4495630,1129102,2021-04-27 18:06:48
1881,32,Telangana,4400003,3837190,562813,2021-04-27 18:06:48
1882,33,Tripura,1113260,856586,256674,2021-04-27 18:06:48
1883,34,Uttar Pradesh,12061238,9953817,2107421,2021-04-27 18:06:48
1884,35,Uttarakhand,1953190,1587147,366043,2021-04-27 18:06:48
1885,36,West Bengal,10437665,8467133,1970532,2021-04-27 18:06:48
1886,37,Daman and Diu,45747,39124,6623,2021-04-27 18:06:48
1887,1,Andaman and Nicobar Islands,101770,91394,10376,2021-04-28 18:07:50
1888,2,Andhra Pradesh,6281949,4955046,1326903,2021-04-28 18:07:50
1889,3,Arunachal Pradesh,227853,176888,50965,2021-04-28 18:07:50
1890,4,Assam,2242653,1766829,475824,2021-04-28 18:07:50
1891,5,Bihar,6761471,5752082,1009389,2021-04-28 18:07:50
1892,6,Chandigarh,196055,151928,44127,2021-04-28 18:07:50
1893,7,Chhattisgarh,5469617,4807697,661920,2021-04-28 18:07:50
1894,8,Dadra and Nagar Haveli,46903,38831,8072,2021-04-28 18:07:50
1895,9,Delhi,3147893,2512508,635385,2021-04-28 18:07:50
1896,10,Goa,331720,262802,68918,2021-04-28 18:07:50
1897,11,Gujarat,12053881,9787160,2266721,2021-04-28 18:07:50
1898,12,Haryana,3675837,3147907,527930,2021-04-28 18:07:50
1899,13,Himachal Pradesh,1689867,1468126,221741,2021-04-28 18:07:50
1900,14,Jammu and Kashmir,2256066,1904409,351657,2021-04-28 18:07:50
1901,15,Jharkhand,3053082,2603179,449903,2021-04-28 18:07:50
1902,16,Karnataka,9276973,7864503,1412470,2021-04-28 18:07:50
1903,17,Kerala,7144083,5967887,1176196,2021-04-28 18:07:50
1904,18,Ladakh,105808,73967,31841,2021-04-28 18:07:50
1905,19,Lakshadweep,22090,18120,3970,2021-04-28 18:07:50
1906,20,Madhya Pradesh,8071696,7020074,1051622,2021-04-28 18:07:50
1907,21,Maharashtra,15577636,13184469,2393167,2021-04-28 18:07:50
1908,22,Manipur,214148,155151,58997,2021-04-28 18:07:50
1909,23,Meghalaya,258617,201997,56620,2021-04-28 18:07:50
1910,24,Mizoram,243364,199452,43912,2021-04-28 18:07:50
1911,25,Nagaland,189590,150753,38837,2021-04-28 18:07:50
1912,26,Odisha,5741648,4867136,874512,2021-04-28 18:07:50
1913,27,Puducherry,190808,166115,24693,2021-04-28 18:07:50
1914,28,Punjab,3211403,2837315,374088,2021-04-28 18:07:50
1915,29,Rajasthan,12811445,10669656,2141789,2021-04-28 18:07:50
1916,30,Sikkim,196919,158440,38479,2021-04-28 18:07:50
1917,31,Tamil Nadu,5740648,4544279,1196369,2021-04-28 18:07:50
1918,32,Telangana,4542064,3955399,586665,2021-04-28 18:07:50
1919,33,Tripura,1139662,866008,273654,2021-04-28 18:07:50
1920,34,Uttar Pradesh,12169041,10018842,2150199,2021-04-28 18:07:50
1921,35,Uttarakhand,1992077,1612469,379608,2021-04-28 18:07:50
1922,36,West Bengal,10630769,8539976,2090793,2021-04-28 18:07:50
1923,37,Daman and Diu,46286,39385,6901,2021-04-28 18:07:50
1924,1,Andaman and Nicobar Islands,102998,92417,10581,2021-04-29 18:06:12
1925,2,Andhra Pradesh,6353841,4988411,1365430,2021-04-29 18:06:12
1926,3,Arunachal Pradesh,234677,182123,52554,2021-04-29 18:06:12
1927,4,Assam,2349267,1846567,502700,2021-04-29 18:06:12
1928,5,Bihar,6869722,5821599,1048123,2021-04-29 18:06:12
1929,6,Chandigarh,201907,155689,46218,2021-04-29 18:06:12
1930,7,Chhattisgarh,5507510,4823914,683596,2021-04-29 18:06:12
1931,8,Dadra and Nagar Haveli,47279,39016,8263,2021-04-29 18:06:12
1932,9,Delhi,3224828,2558135,666693,2021-04-29 18:06:12
1933,10,Goa,340659,269749,70910,2021-04-29 18:06:12
1934,11,Gujarat,12251389,9873924,2377465,2021-04-29 18:06:12
1935,12,Haryana,3723444,3177552,545892,2021-04-29 18:06:12
1936,13,Himachal Pradesh,1743174,1505397,237777,2021-04-29 18:06:12
1937,14,Jammu and Kashmir,2311019,1946913,364106,2021-04-29 18:06:12
1938,15,Jharkhand,3083117,2619343,463774,2021-04-29 18:06:12
1939,16,Karnataka,9400272,7940695,1459577,2021-04-29 18:06:12
1940,17,Kerala,7229177,6006391,1222786,2021-04-29 18:06:12
1941,18,Ladakh,107405,74391,33014,2021-04-29 18:06:12
1942,19,Lakshadweep,22410,18386,4024,2021-04-29 18:06:12
1943,20,Madhya Pradesh,8077002,7022419,1054583,2021-04-29 18:06:12
1944,21,Maharashtra,15870448,13360080,2510368,2021-04-29 18:06:12
1945,22,Manipur,228164,168095,60069,2021-04-29 18:06:12
1946,23,Meghalaya,275009,216622,58387,2021-04-29 18:06:12
1947,24,Mizoram,250446,206116,44330,2021-04-29 18:06:12
1948,25,Nagaland,195428,155613,39815,2021-04-29 18:06:12
1949,26,Odisha,5778140,4889024,889116,2021-04-29 18:06:12
1950,27,Puducherry,193958,167707,26251,2021-04-29 18:06:12
1951,28,Punjab,3292863,2896032,396831,2021-04-29 18:06:12
1952,29,Rajasthan,12936289,10745384,2190905,2021-04-29 18:06:12
1953,30,Sikkim,200586,159827,40759,2021-04-29 18:06:12
1954,31,Tamil Nadu,5845197,4589747,1255450,2021-04-29 18:06:12
1955,32,Telangana,4612780,4010610,602170,2021-04-29 18:06:12
1956,33,Tripura,1189803,882252,307551,2021-04-29 18:06:12
1957,34,Uttar Pradesh,12353995,10125866,2228129,2021-04-29 18:06:12
1958,35,Uttarakhand,2036059,1639998,396061,2021-04-29 18:06:12
1959,36,West Bengal,10781641,8596240,2185401,2021-04-29 18:06:12
1960,37,Daman and Diu,46869,39664,7205,2021-04-29 18:06:12
1961,1,Andaman and Nicobar Islands,104374,93493,10881,2021-04-30 18:07:48
1962,2,Andhra Pradesh,6579034,5112011,1467023,2021-04-30 18:07:48
1963,3,Arunachal Pradesh,241423,187103,54320,2021-04-30 18:07:48
1964,4,Assam,2480734,1946800,533934,2021-04-30 18:07:48
1965,5,Bihar,6967492,5881859,1085633,2021-04-30 18:07:48
1966,6,Chandigarh,208489,160071,48418,2021-04-30 18:07:48
1967,7,Chhattisgarh,5570909,4853003,717906,2021-04-30 18:07:48
1968,8,Dadra and Nagar Haveli,47829,39288,8541,2021-04-30 18:07:48
1969,9,Delhi,3271950,2581651,690299,2021-04-30 18:07:48
1970,10,Goa,349718,277125,72593,2021-04-30 18:07:48
1971,11,Gujarat,12457754,9965407,2492347,2021-04-30 18:07:48
1972,12,Haryana,3758377,3199035,559342,2021-04-30 18:07:48
1973,13,Himachal Pradesh,1793341,1541255,252086,2021-04-30 18:07:48
1974,14,Jammu and Kashmir,2348049,1974919,373130,2021-04-30 18:07:48
1975,15,Jharkhand,3114125,2635993,478132,2021-04-30 18:07:48
1976,16,Karnataka,9642439,8090917,1551522,2021-04-30 18:07:48
1977,17,Kerala,7376934,6051350,1325584,2021-04-30 18:07:48
1978,18,Ladakh,108166,74571,33595,2021-04-30 18:07:48
1979,19,Lakshadweep,23024,18888,4136,2021-04-30 18:07:48
1980,20,Madhya Pradesh,8079538,7023042,1056496,2021-04-30 18:07:48
1981,21,Maharashtra,16183847,13561437,2622410,2021-04-30 18:07:48
1982,22,Manipur,250108,188954,61154,2021-04-30 18:07:48
1983,23,Meghalaya,290380,230464,59916,2021-04-30 18:07:48
1984,24,Mizoram,256067,211334,44733,2021-04-30 18:07:48
1985,25,Nagaland,198817,158602,40215,2021-04-30 18:07:48
1986,26,Odisha,5856695,4928197,928498,2021-04-30 18:07:48
1987,27,Puducherry,197864,169488,28376,2021-04-30 18:07:48
1988,28,Punjab,3394080,2968888,425192,2021-04-30 18:07:48
1989,29,Rajasthan,13021948,10797155,2224793,2021-04-30 18:07:48
1990,30,Sikkim,203966,161083,42883,2021-04-30 18:07:48
1991,31,Tamil Nadu,5947056,4635084,1311972,2021-04-30 18:07:48
1992,32,Telangana,4780184,4151762,628422,2021-04-30 18:07:48
1993,33,Tripura,1236761,898611,338150,2021-04-30 18:07:48
1994,34,Uttar Pradesh,12557806,10240750,2317056,2021-04-30 18:07:48
1995,35,Uttarakhand,2079214,1665065,414149,2021-04-30 18:07:48
1996,36,West Bengal,10971948,8662227,2309721,2021-04-30 18:07:48
1997,37,Daman and Diu,47667,40070,7597,2021-04-30 18:07:48
1998,1,Andaman and Nicobar Islands,105090,94002,11088,2021-05-01 18:04:25
1999,2,Andhra Pradesh,6694297,5174960,1519337,2021-05-01 18:04:25
2000,3,Arunachal Pradesh,245524,189910,55614,2021-05-01 18:04:25
2001,4,Assam,2574065,2020530,553535,2021-05-01 18:04:25
2002,5,Bihar,7047770,5928725,1119045,2021-05-01 18:04:25
2003,6,Chandigarh,213216,163599,49617,2021-05-01 18:04:25
2004,7,Chhattisgarh,5620382,4876021,744361,2021-05-01 18:04:25
2005,8,Dadra and Nagar Haveli,48082,39429,8653,2021-05-01 18:04:25
2006,9,Delhi,3323249,2611942,711307,2021-05-01 18:04:25
2007,10,Goa,355269,282005,73264,2021-05-01 18:04:25
2008,11,Gujarat,12679389,10092582,2586807,2021-05-01 18:04:25
2009,12,Haryana,3776747,3211614,565133,2021-05-01 18:04:25
2010,13,Himachal Pradesh,1823400,1562272,261128,2021-05-01 18:04:25
2011,14,Jammu and Kashmir,2376239,1995989,380250,2021-05-01 18:04:25
2012,15,Jharkhand,3135680,2647485,488195,2021-05-01 18:04:25
2013,16,Karnataka,9776943,8178490,1598453,2021-05-01 18:04:25
2014,17,Kerala,7425416,6069726,1355690,2021-05-01 18:04:25
2015,18,Ladakh,109442,74984,34458,2021-05-01 18:04:25
2016,19,Lakshadweep,23444,19170,4274,2021-05-01 18:04:25
2017,20,Madhya Pradesh,8147203,7043286,1103917,2021-05-01 18:04:25
2018,21,Maharashtra,16292753,13637082,2655671,2021-05-01 18:04:25
2019,22,Manipur,263966,202264,61702,2021-05-01 18:04:25
2020,23,Meghalaya,298016,237480,60536,2021-05-01 18:04:25
2021,24,Mizoram,258683,213866,44817,2021-05-01 18:04:25
2022,25,Nagaland,199845,159555,40290,2021-05-01 18:04:25
2023,26,Odisha,5871726,4938147,933579,2021-05-01 18:04:25
2024,27,Puducherry,199568,170421,29147,2021-05-01 18:04:25
2025,28,Punjab,3465616,3022501,443115,2021-05-01 18:04:25
2026,29,Rajasthan,13084309,10835900,2248409,2021-05-01 18:04:25
2027,30,Sikkim,204960,161364,43596,2021-05-01 18:04:25
2028,31,Tamil Nadu,6030884,4671707,1359177,2021-05-01 18:04:25
2029,32,Telangana,4787544,4157933,629611,2021-05-01 18:04:25
2030,33,Tripura,1261570,907499,354071,2021-05-01 18:04:25
2031,34,Uttar Pradesh,12700692,10331285,2369407,2021-05-01 18:04:25
2032,35,Uttarakhand,2099055,1674974,424081,2021-05-01 18:04:25
2033,36,West Bengal,11058053,8689947,2368106,2021-05-01 18:04:25
2034,37,Daman and Diu,48238,40324,7914,2021-05-01 18:04:25
2035,1,Andaman and Nicobar Islands,105285,94125,11160,2021-05-02 18:05:12
2036,2,Andhra Pradesh,6696325,5176393,1519932,2021-05-02 18:05:12
2037,3,Arunachal Pradesh,246580,190514,56066,2021-05-02 18:05:12
2038,4,Assam,2589899,2033174,556725,2021-05-02 18:05:12
2039,5,Bihar,7110550,5965407,1145143,2021-05-02 18:05:12
2040,6,Chandigarh,215894,165617,50277,2021-05-02 18:05:12
2041,7,Chhattisgarh,5646987,4887659,759328,2021-05-02 18:05:12
2042,8,Dadra and Nagar Haveli,48131,39454,8677,2021-05-02 18:05:12
2043,9,Delhi,3324902,2613227,711675,2021-05-02 18:05:12
2044,10,Goa,358280,284560,73720,2021-05-02 18:05:12
2045,11,Gujarat,12803024,10161231,2641793,2021-05-02 18:05:12
2046,12,Haryana,3796956,3230331,566625,2021-05-02 18:05:12
2047,13,Himachal Pradesh,1828966,1566274,262692,2021-05-02 18:05:12
2048,14,Jammu and Kashmir,2415072,2027309,387763,2021-05-02 18:05:12
2049,15,Jharkhand,3146799,2653112,493687,2021-05-02 18:05:12
2050,16,Karnataka,9817518,8204770,1612748,2021-05-02 18:05:12
2051,17,Kerala,7426176,6069760,1356416,2021-05-02 18:05:12
2052,18,Ladakh,109696,75065,34631,2021-05-02 18:05:12
2053,19,Lakshadweep,23634,19319,4315,2021-05-02 18:05:12
2054,20,Madhya Pradesh,8154964,7046019,1108945,2021-05-02 18:05:12
2055,21,Maharashtra,16342814,13677591,2665223,2021-05-02 18:05:12
2056,22,Manipur,266791,205037,61754,2021-05-02 18:05:12
2057,23,Meghalaya,298411,237840,60571,2021-05-02 18:05:12
2058,24,Mizoram,258830,213944,44886,2021-05-02 18:05:12
2059,25,Nagaland,200279,159934,40345,2021-05-02 18:05:12
2060,26,Odisha,5874337,4939787,934550,2021-05-02 18:05:12
2061,27,Puducherry,200100,170746,29354,2021-05-02 18:05:12
2062,28,Punjab,3498524,3047712,450812,2021-05-02 18:05:12
2063,29,Rajasthan,13173409,10894243,2279166,2021-05-02 18:05:12
2064,30,Sikkim,204990,161376,43614,2021-05-02 18:05:12
2065,31,Tamil Nadu,6046415,4679335,1367080,2021-05-02 18:05:12
2066,32,Telangana,4787811,4158090,629721,2021-05-02 18:05:12
2067,33,Tripura,1267044,909670,357374,2021-05-02 18:05:12
2068,34,Uttar Pradesh,12705437,10334346,2371091,2021-05-02 18:05:12
2069,35,Uttarakhand,2105869,1677900,427969,2021-05-02 18:05:12
2070,36,West Bengal,11066324,8692844,2373480,2021-05-02 18:05:12
2071,37,Daman and Diu,48488,40436,8052,2021-05-02 18:05:12
2072,1,Andaman and Nicobar Islands,106250,94633,11617,2021-05-03 18:04:55
2073,2,Andhra Pradesh,6732767,5195851,1536916,2021-05-03 18:04:55
2074,3,Arunachal Pradesh,252527,193841,58686,2021-05-03 18:04:55
2075,4,Assam,2675846,2096948,578898,2021-05-03 18:04:55
2076,5,Bihar,7233171,6027693,1205478,2021-05-03 18:04:55
2077,6,Chandigarh,220462,168672,51790,2021-05-03 18:04:55
2078,7,Chhattisgarh,5684458,4902668,781790,2021-05-03 18:04:55
2079,8,Dadra and Nagar Haveli,48439,39587,8852,2021-05-03 18:04:55
2080,9,Delhi,3415728,2676373,739355,2021-05-03 18:04:55
2081,10,Goa,363592,288805,74787,2021-05-03 18:04:55
2082,11,Gujarat,12966110,10243032,2723078,2021-05-03 18:04:55
2083,12,Haryana,3855063,3279593,575470,2021-05-03 18:04:55
2084,13,Himachal Pradesh,1874042,1595354,278688,2021-05-03 18:04:55
2085,14,Jammu and Kashmir,2467470,2065375,402095,2021-05-03 18:04:55
2086,15,Jharkhand,3165998,2661873,504125,2021-05-03 18:04:55
2087,16,Karnataka,9901051,8253648,1647403,2021-05-03 18:04:55
2088,17,Kerala,7511454,6092349,1419105,2021-05-03 18:04:55
2089,18,Ladakh,111070,75744,35326,2021-05-03 18:04:55
2090,19,Lakshadweep,23908,19460,4448,2021-05-03 18:04:55
2091,20,Madhya Pradesh,8228404,7065585,1162819,2021-05-03 18:04:55
2092,21,Maharashtra,16425887,13739753,2686134,2021-05-03 18:04:55
2093,22,Manipur,281500,218548,62952,2021-05-03 18:04:55
2094,23,Meghalaya,307452,245544,61908,2021-05-03 18:04:55
2095,24,Mizoram,263667,218549,45118,2021-05-03 18:04:55
2096,25,Nagaland,205316,163607,41709,2021-05-03 18:04:55
2097,26,Odisha,5920244,4958904,961340,2021-05-03 18:04:55
2098,27,Puducherry,202793,171878,30915,2021-05-03 18:04:55
2099,28,Punjab,3535078,3073058,462020,2021-05-03 18:04:55
2100,29,Rajasthan,13351069,11008158,2342911,2021-05-03 18:04:55
2101,30,Sikkim,207754,162016,45738,2021-05-03 18:04:55
2102,31,Tamil Nadu,6135244,4716835,1418409,2021-05-03 18:04:55
2103,32,Telangana,4815920,4178677,637243,2021-05-03 18:04:55
2104,33,Tripura,1284939,915489,369450,2021-05-03 18:04:55
2105,34,Uttar Pradesh,12884995,10439785,2445210,2021-05-03 18:04:55
2106,35,Uttarakhand,2117345,1683130,434215,2021-05-03 18:04:55
2107,36,West Bengal,11256097,8725020,2531077,2021-05-03 18:04:55
2108,37,Daman and Diu,49026,40640,8386,2021-05-03 18:04:55
2109,1,Andaman and Nicobar Islands,107018,95064,11954,2021-05-04 18:07:43
2110,2,Andhra Pradesh,6748028,5204180,1543848,2021-05-04 18:07:43
2111,3,Arunachal Pradesh,256929,196476,60453,2021-05-04 18:07:43
2112,4,Assam,2751204,2152500,598704,2021-05-04 18:07:43
2113,5,Bihar,7359866,6092049,1267817,2021-05-04 18:07:43
2114,6,Chandigarh,225542,172057,53485,2021-05-04 18:07:43
2115,7,Chhattisgarh,5715512,4914311,801201,2021-05-04 18:07:43
2116,8,Dadra and Nagar Haveli,48688,39710,8978,2021-05-04 18:07:43
2117,9,Delhi,3507635,2742953,764682,2021-05-04 18:07:43
2118,10,Goa,368857,292908,75949,2021-05-04 18:07:43
2119,11,Gujarat,13094157,10330960,2763197,2021-05-04 18:07:43
2120,12,Haryana,3926299,3335067,591232,2021-05-04 18:07:43
2121,13,Himachal Pradesh,1920953,1624444,296509,2021-05-04 18:07:43
2122,14,Jammu and Kashmir,2503624,2091960,411664,2021-05-04 18:07:43
2123,15,Jharkhand,3186484,2671304,515180,2021-05-04 18:07:43
2124,16,Karnataka,9962735,8289078,1673657,2021-05-04 18:07:43
2125,17,Kerala,7577304,6110419,1466885,2021-05-04 18:07:43
2126,18,Ladakh,112903,77322,35581,2021-05-04 18:07:43
2127,19,Lakshadweep,24226,19666,4560,2021-05-04 18:07:43
2128,20,Madhya Pradesh,8249533,7071530,1178003,2021-05-04 18:07:43
2129,21,Maharashtra,16528345,13799328,2729017,2021-05-04 18:07:43
2130,22,Manipur,292122,228369,63753,2021-05-04 18:07:43
2131,23,Meghalaya,314897,251797,63100,2021-05-04 18:07:43
2132,24,Mizoram,267561,221866,45695,2021-05-04 18:07:43
2133,25,Nagaland,209918,166102,43816,2021-05-04 18:07:43
2134,26,Odisha,5951030,4974065,976965,2021-05-04 18:07:43
2135,27,Puducherry,204860,172686,32174,2021-05-04 18:07:43
2136,28,Punjab,3556000,3087605,468395,2021-05-04 18:07:43
2137,29,Rajasthan,13497182,11108037,2389145,2021-05-04 18:07:43
2138,30,Sikkim,210281,162666,47615,2021-05-04 18:07:43
2139,31,Tamil Nadu,6210666,4750360,1460306,2021-05-04 18:07:43
2140,32,Telangana,4881513,4227755,653758,2021-05-04 18:07:43
2141,33,Tripura,1307268,921704,385564,2021-05-04 18:07:43
2142,34,Uttar Pradesh,13062635,10544891,2517744,2021-05-04 18:07:43
2143,35,Uttarakhand,2149462,1695482,453980,2021-05-04 18:07:43
2144,36,West Bengal,11409897,8750404,2659493,2021-05-04 18:07:43
2145,37,Daman and Diu,49618,40844,8774,2021-05-04 18:07:43
2146,1,Andaman and Nicobar Islands,107955,95500,12455,2021-05-05 18:07:25
2147,2,Andhra Pradesh,6947225,5273196,1674029,2021-05-05 18:07:25
2148,3,Arunachal Pradesh,261968,199517,62451,2021-05-05 18:07:25
2149,4,Assam,2785838,2176851,608987,2021-05-05 18:07:25
2150,5,Bihar,7475869,6150797,1325072,2021-05-05 18:07:25
2151,6,Chandigarh,230822,175618,55204,2021-05-05 18:07:25
2152,7,Chhattisgarh,5746229,4925570,820659,2021-05-05 18:07:25
2153,8,Dadra and Nagar Haveli,48965,39856,9109,2021-05-05 18:07:25
2154,9,Delhi,3576091,2800013,776078,2021-05-05 18:07:25
2155,10,Goa,373997,296579,77418,2021-05-05 18:07:25
2156,11,Gujarat,13267196,10417828,2849368,2021-05-05 18:07:25
2157,12,Haryana,3987098,3374963,612135,2021-05-05 18:07:25
2158,13,Himachal Pradesh,1956253,1645491,310762,2021-05-05 18:07:25
2159,14,Jammu and Kashmir,2560453,2133638,426815,2021-05-05 18:07:25
2160,15,Jharkhand,3211894,2681933,529961,2021-05-05 18:07:25
2161,16,Karnataka,10150823,8387120,1763703,2021-05-05 18:07:25
2162,17,Kerala,7600484,6118358,1482126,2021-05-05 18:07:25
2163,18,Ladakh,115161,79276,35885,2021-05-05 18:07:25
2164,19,Lakshadweep,24766,19872,4894,2021-05-05 18:07:25
2165,20,Madhya Pradesh,8380264,7110730,1269534,2021-05-05 18:07:25
2166,21,Maharashtra,16802255,13935541,2866714,2021-05-05 18:07:25
2167,22,Manipur,304470,239758,64712,2021-05-05 18:07:25
2168,23,Meghalaya,321391,257079,64312,2021-05-05 18:07:25
2169,24,Mizoram,271141,225232,45909,2021-05-05 18:07:25
2170,25,Nagaland,213511,168825,44686,2021-05-05 18:07:25
2171,26,Odisha,5975193,4987030,988163,2021-05-05 18:07:25
2172,27,Puducherry,207774,173767,34007,2021-05-05 18:07:25
2173,28,Punjab,3636037,3137052,498985,2021-05-05 18:07:25
2174,29,Rajasthan,13626322,11195379,2430943,2021-05-05 18:07:25
2175,30,Sikkim,212688,163194,49494,2021-05-05 18:07:25
2176,31,Tamil Nadu,6279062,4781479,1497583,2021-05-05 18:07:25
2177,32,Telangana,4960587,4275187,685400,2021-05-05 18:07:25
2178,33,Tripura,1328697,927468,401229,2021-05-05 18:07:25
2179,34,Uttar Pradesh,13228006,10642247,2585759,2021-05-05 18:07:25
2180,35,Uttarakhand,2197687,1712874,484813,2021-05-05 18:07:25
2181,36,West Bengal,11506727,8764695,2742032,2021-05-05 18:07:25
2182,37,Daman and Diu,50339,41128,9211,2021-05-05 18:07:25
2183,1,Andaman and Nicobar Islands,109060,96229,12831,2021-05-06 18:02:42
2184,2,Andhra Pradesh,7140106,5345545,1794561,2021-05-06 18:02:42
2185,3,Arunachal Pradesh,267741,202965,64776,2021-05-06 18:02:42
2186,4,Assam,2835452,2211808,623644,2021-05-06 18:02:42
2187,5,Bihar,7604097,6212706,1391391,2021-05-06 18:02:42
2188,6,Chandigarh,237473,179429,58044,2021-05-06 18:02:42
2189,7,Chhattisgarh,5786848,4939907,846941,2021-05-06 18:02:42
2190,8,Dadra and Nagar Haveli,49408,39996,9412,2021-05-06 18:02:42
2191,9,Delhi,3693814,2883317,810497,2021-05-06 18:02:42
2192,10,Goa,379927,300663,79264,2021-05-06 18:02:42
2193,11,Gujarat,13473812,10505574,2968238,2021-05-06 18:02:42
2194,12,Haryana,4094206,3447474,646732,2021-05-06 18:02:42
2195,13,Himachal Pradesh,2005160,1671620,333540,2021-05-06 18:02:42
2196,14,Jammu and Kashmir,2610901,2166988,443913,2021-05-06 18:02:42
2197,15,Jharkhand,3233186,2691611,541575,2021-05-06 18:02:42
2198,16,Karnataka,10314190,8468403,1845787,2021-05-06 18:02:42
2199,17,Kerala,7705285,6137985,1567300,2021-05-06 18:02:42
2200,18,Ladakh,117233,81061,36172,2021-05-06 18:02:42
2201,19,Lakshadweep,25040,19986,5054,2021-05-06 18:02:42
2202,20,Madhya Pradesh,8490151,7146019,1344132,2021-05-06 18:02:42
2203,21,Maharashtra,17296109,14214775,3081334,2021-05-06 18:02:42
2204,22,Manipur,314431,248868,65563,2021-05-06 18:02:42
2205,23,Meghalaya,330208,264289,65919,2021-05-06 18:02:42
2206,24,Mizoram,275391,229045,46346,2021-05-06 18:02:42
2207,25,Nagaland,216162,170531,45631,2021-05-06 18:02:42
2208,26,Odisha,6028359,5006410,1021949,2021-05-06 18:02:42
2209,27,Puducherry,210910,174826,36084,2021-05-06 18:02:42
2210,28,Punjab,3718025,3189159,528866,2021-05-06 18:02:42
2211,29,Rajasthan,13736919,11266670,2470249,2021-05-06 18:02:42
2212,30,Sikkim,215456,164073,51383,2021-05-06 18:02:42
2213,31,Tamil Nadu,6379188,4823176,1556012,2021-05-06 18:02:42
2214,32,Telangana,5042065,4325903,716162,2021-05-06 18:02:42
2215,33,Tripura,1362400,936213,426187,2021-05-06 18:02:42
2216,34,Uttar Pradesh,13402535,10742503,2660032,2021-05-06 18:02:42
2217,35,Uttarakhand,2256480,1734466,522014,2021-05-06 18:02:42
2218,36,West Bengal,11594723,8777268,2817455,2021-05-06 18:02:42
2219,37,Daman and Diu,51152,41429,9723,2021-05-06 18:02:42
2220,1,Andaman and Nicobar Islands,110161,96970,13191,2021-05-07 18:04:52
2221,2,Andhra Pradesh,7255219,5393064,1862155,2021-05-07 18:04:52
2222,3,Arunachal Pradesh,273182,205709,67473,2021-05-07 18:04:52
2223,4,Assam,2919568,2277554,642014,2021-05-07 18:04:52
2224,5,Bihar,7698767,6261291,1437476,2021-05-07 18:04:52
2225,6,Chandigarh,243450,183067,60383,2021-05-07 18:04:52
2226,7,Chhattisgarh,5815669,4950080,865589,2021-05-07 18:04:52
2227,8,Dadra and Nagar Haveli,49910,40171,9739,2021-05-07 18:04:52
2228,9,Delhi,3774068,2951479,822589,2021-05-07 18:04:52
2229,10,Goa,386450,305206,81244,2021-05-07 18:04:52
2230,11,Gujarat,13680484,10593635,3086849,2021-05-07 18:04:52
2231,12,Haryana,4204923,3518724,686199,2021-05-07 18:04:52
2232,13,Himachal Pradesh,2037602,1688202,349400,2021-05-07 18:04:52
2233,14,Jammu and Kashmir,2673010,2208633,464377,2021-05-07 18:04:52
2234,15,Jharkhand,3257332,2702393,554939,2021-05-07 18:04:52
2235,16,Karnataka,10450470,8527328,1923142,2021-05-07 18:04:52
2236,17,Kerala,7869269,6168780,1700489,2021-05-07 18:04:52
2237,18,Ladakh,118299,81960,36339,2021-05-07 18:04:52
2238,19,Lakshadweep,25396,20131,5265,2021-05-07 18:04:52
2239,20,Madhya Pradesh,8508272,7151755,1356517,2021-05-07 18:04:52
2240,21,Maharashtra,17693374,14458039,3235335,2021-05-07 18:04:52
2241,22,Manipur,322790,256439,66351,2021-05-07 18:04:52
2242,23,Meghalaya,338720,271522,67198,2021-05-07 18:04:52
2243,24,Mizoram,277545,230710,46835,2021-05-07 18:04:52
2244,25,Nagaland,218384,172092,46292,2021-05-07 18:04:52
2245,26,Odisha,6115427,5032726,1082701,2021-05-07 18:04:52
2246,27,Puducherry,214047,175852,38195,2021-05-07 18:04:52
2247,28,Punjab,3790968,3234007,556961,2021-05-07 18:04:52
2248,29,Rajasthan,13891493,11346992,2544501,2021-05-07 18:04:52
2249,30,Sikkim,218368,164598,53770,2021-05-07 18:04:52
2250,31,Tamil Nadu,6478830,4866561,1612269,2021-05-07 18:04:52
2251,32,Telangana,5122572,4376415,746157,2021-05-07 18:04:52
2252,33,Tripura,1396362,946489,449873,2021-05-07 18:04:52
2253,34,Uttar Pradesh,13559957,10833025,2726932,2021-05-07 18:04:52
2254,35,Uttarakhand,2307663,1753256,554407,2021-05-07 18:04:52
2255,36,West Bengal,11839680,8808010,3031670,2021-05-07 18:04:52
2256,37,Daman and Diu,52319,41962,10357,2021-05-07 18:04:52
2257,1,Andaman and Nicobar Islands,111168,97639,13529,2021-05-08 18:04:47
2258,2,Andhra Pradesh,7410800,5436592,1974208,2021-05-08 18:04:47
2259,3,Arunachal Pradesh,277640,207746,69894,2021-05-08 18:04:47
2260,4,Assam,3002857,2346318,656539,2021-05-08 18:04:47
2261,5,Bihar,7782756,6304398,1478358,2021-05-08 18:04:47
2262,6,Chandigarh,250441,187445,62996,2021-05-08 18:04:47
2263,7,Chhattisgarh,5842656,4958357,884299,2021-05-08 18:04:47
2264,8,Dadra and Nagar Haveli,50355,40349,10006,2021-05-08 18:04:47
2265,9,Delhi,3905912,3044458,861454,2021-05-08 18:04:47
2266,10,Goa,392342,309334,83008,2021-05-08 18:04:47
2267,11,Gujarat,13881007,10676626,3204381,2021-05-08 18:04:47
2268,12,Haryana,4288127,3573590,714537,2021-05-08 18:04:47
2269,13,Himachal Pradesh,2058866,1699206,359660,2021-05-08 18:04:47
2270,14,Jammu and Kashmir,2717486,2236255,481231,2021-05-08 18:04:47
2271,15,Jharkhand,3284802,2714194,570608,2021-05-08 18:04:47
2272,16,Karnataka,10596894,8577077,2019817,2021-05-08 18:04:47
2273,17,Kerala,7951983,6187280,1764703,2021-05-08 18:04:47
2274,18,Ladakh,119520,83032,36488,2021-05-08 18:04:47
2275,19,Lakshadweep,25693,20240,5453,2021-05-08 18:04:47
2276,20,Madhya Pradesh,8634077,7201637,1432440,2021-05-08 18:04:47
2277,21,Maharashtra,17947420,14628881,3318539,2021-05-08 18:04:47
2278,22,Manipur,330507,263612,66895,2021-05-08 18:04:47
2279,23,Meghalaya,343288,275381,67907,2021-05-08 18:04:47
2280,24,Mizoram,278197,231165,47032,2021-05-08 18:04:47
2281,25,Nagaland,218617,172228,46389,2021-05-08 18:04:47
2282,26,Odisha,6190506,5056397,1134109,2021-05-08 18:04:47
2283,27,Puducherry,216758,176721,40037,2021-05-08 18:04:47
2284,28,Punjab,3859741,3273867,585874,2021-05-08 18:04:47
2285,29,Rajasthan,14086593,11435174,2651419,2021-05-08 18:04:47
2286,30,Sikkim,219141,164772,54369,2021-05-08 18:04:47
2287,31,Tamil Nadu,6546261,4895451,1650810,2021-05-08 18:04:47
2288,32,Telangana,5202960,4388638,814322,2021-05-08 18:04:47
2289,33,Tripura,1418622,952947,465675,2021-05-08 18:04:47
2290,34,Uttar Pradesh,13694748,10914754,2779994,2021-05-08 18:04:47
2291,35,Uttarakhand,2349729,1768741,580988,2021-05-08 18:04:47
2292,36,West Bengal,11952404,8823763,3128641,2021-05-08 18:04:47
2293,37,Daman and Diu,52983,42217,10766,2021-05-08 18:04:47
2294,1,Andaman and Nicobar Islands,111285,97748,13537,2021-05-09 18:05:19
2295,2,Andhra Pradesh,7425692,5443382,1982310,2021-05-09 18:05:19
2296,3,Arunachal Pradesh,278983,208414,70569,2021-05-09 18:05:19
2297,4,Assam,3027029,2366422,660607,2021-05-09 18:05:19
2298,5,Bihar,7905698,6411990,1493708,2021-05-09 18:05:19
2299,6,Chandigarh,254612,190204,64408,2021-05-09 18:05:19
2300,7,Chhattisgarh,5857150,4963503,893647,2021-05-09 18:05:19
2301,8,Dadra and Nagar Haveli,50585,40424,10161,2021-05-09 18:05:19
2302,9,Delhi,3907469,3045394,862075,2021-05-09 18:05:19
2303,10,Goa,394413,310955,83458,2021-05-09 18:05:19
2304,11,Gujarat,14036695,10741045,3295650,2021-05-09 18:05:19
2305,12,Haryana,4344758,3612642,732116,2021-05-09 18:05:19
2306,13,Himachal Pradesh,2065283,1702305,362978,2021-05-09 18:05:19
2307,14,Jammu and Kashmir,2730327,2244582,485745,2021-05-09 18:05:19
2308,15,Jharkhand,3303003,2722859,580144,2021-05-09 18:05:19
2309,16,Karnataka,10643323,8591372,2051951,2021-05-09 18:05:19
2310,17,Kerala,7952556,6187652,1764904,2021-05-09 18:05:19
2311,18,Ladakh,119661,83169,36492,2021-05-09 18:05:19
2312,19,Lakshadweep,25943,20307,5636,2021-05-09 18:05:19
2313,20,Madhya Pradesh,8636212,7202462,1433750,2021-05-09 18:05:19
2314,21,Maharashtra,18063345,14712246,3351099,2021-05-09 18:05:19
2315,22,Manipur,330717,263801,66916,2021-05-09 18:05:19
2316,23,Meghalaya,343383,275458,67925,2021-05-09 18:05:19
2317,24,Mizoram,278252,231200,47052,2021-05-09 18:05:19
2318,25,Nagaland,219061,172658,46403,2021-05-09 18:05:19
2319,26,Odisha,6199403,5060884,1138519,2021-05-09 18:05:19
2320,27,Puducherry,217269,176917,40352,2021-05-09 18:05:19
2321,28,Punjab,3900797,3298768,602029,2021-05-09 18:05:19
2322,29,Rajasthan,14177991,11498654,2679337,2021-05-09 18:05:19
2323,30,Sikkim,219312,164805,54507,2021-05-09 18:05:19
2324,31,Tamil Nadu,6569914,4906062,1663852,2021-05-09 18:05:19
2325,32,Telangana,5205226,4389592,815634,2021-05-09 18:05:19
2326,33,Tripura,1421511,953744,467767,2021-05-09 18:05:19
2327,34,Uttar Pradesh,13697577,10916895,2780682,2021-05-09 18:05:19
2328,35,Uttarakhand,2373371,1777937,595434,2021-05-09 18:05:19
2329,36,West Bengal,11963861,8825922,3137939,2021-05-09 18:05:19
2330,37,Daman and Diu,53201,42302,10899,2021-05-09 18:05:19
2331,1,Andaman and Nicobar Islands,112403,98439,13964,2021-05-10 18:02:50
2332,2,Andhra Pradesh,7427778,5443951,1983827,2021-05-10 18:02:50
2333,3,Arunachal Pradesh,285021,210862,74159,2021-05-10 18:02:50
2334,4,Assam,3120516,2434046,686470,2021-05-10 18:02:50
2335,5,Bihar,8108459,6552924,1555535,2021-05-10 18:02:50
2336,6,Chandigarh,260309,193540,66769,2021-05-10 18:02:50
2337,7,Chhattisgarh,5906806,4978422,928384,2021-05-10 18:02:50
2338,8,Dadra and Nagar Haveli,51038,40551,10487,2021-05-10 18:02:50
2339,9,Delhi,4051457,3142198,909259,2021-05-10 18:02:50
2340,10,Goa,399718,314583,85135,2021-05-10 18:02:50
2341,11,Gujarat,14301060,10840347,3460713,2021-05-10 18:02:50
2342,12,Haryana,4475905,3692472,783433,2021-05-10 18:02:50
2343,13,Himachal Pradesh,2097748,1717794,379954,2021-05-10 18:02:50
2344,14,Jammu and Kashmir,2762379,2261462,500917,2021-05-10 18:02:50
2345,15,Jharkhand,3336638,2738946,597692,2021-05-10 18:02:50
2346,16,Karnataka,10772140,8638830,2133310,2021-05-10 18:02:50
2347,17,Kerala,8066700,6216882,1849818,2021-05-10 18:02:50
2348,18,Ladakh,120835,84093,36742,2021-05-10 18:02:50
2349,19,Lakshadweep,26489,20513,5976,2021-05-10 18:02:50
2350,20,Madhya Pradesh,8765843,7251862,1513981,2021-05-10 18:02:50
2351,21,Maharashtra,18380699,14888694,3492005,2021-05-10 18:02:50
2352,22,Manipur,341766,273723,68043,2021-05-10 18:02:50
2353,23,Meghalaya,354169,284513,69656,2021-05-10 18:02:50
2354,24,Mizoram,281704,232953,48751,2021-05-10 18:02:50
2355,25,Nagaland,223069,175150,47919,2021-05-10 18:02:50
2356,26,Odisha,6344014,5094833,1249181,2021-05-10 18:02:50
2357,27,Puducherry,220887,178079,42808,2021-05-10 18:02:50
2358,28,Punjab,3981861,3343731,638130,2021-05-10 18:02:50
2359,29,Rajasthan,14374162,11636945,2737217,2021-05-10 18:02:50
2360,30,Sikkim,221248,165201,56047,2021-05-10 18:02:50
2361,31,Tamil Nadu,6676837,4951333,1725504,2021-05-10 18:02:50
2362,32,Telangana,5313900,4406542,907358,2021-05-10 18:02:50
2363,33,Tripura,1446246,960991,485255,2021-05-10 18:02:50
2364,34,Uttar Pradesh,13881053,11025900,2855153,2021-05-10 18:02:50
2365,35,Uttarakhand,2445484,1813356,632128,2021-05-10 18:02:50
2366,36,West Bengal,12108661,8844778,3263883,2021-05-10 18:02:50
2367,37,Daman and Diu,53916,42574,11342,2021-05-10 18:02:50
2368,1,Andaman and Nicobar Islands,113019,98845,14174,2021-05-11 18:03:03
2369,2,Andhra Pradesh,7463899,5450913,2012986,2021-05-11 18:03:03
2370,3,Arunachal Pradesh,288821,212600,76221,2021-05-11 18:03:03
2371,4,Assam,3197150,2487465,709685,2021-05-11 18:03:03
2372,5,Bihar,8289734,6669849,1619885,2021-05-11 18:03:03
2373,6,Chandigarh,265527,196808,68719,2021-05-11 18:03:03
2374,7,Chhattisgarh,5956903,4993821,963082,2021-05-11 18:03:03
2375,8,Dadra and Nagar Haveli,51427,40638,10789,2021-05-11 18:03:03
2376,9,Delhi,4183896,3229399,954497,2021-05-11 18:03:03
2377,10,Goa,405500,318352,87148,2021-05-11 18:03:03
2378,11,Gujarat,14610441,10952235,3658206,2021-05-11 18:03:03
2379,12,Haryana,4590300,3764214,826086,2021-05-11 18:03:03
2380,13,Himachal Pradesh,2125140,1730336,394804,2021-05-11 18:03:03
2381,14,Jammu and Kashmir,2792754,2277054,515700,2021-05-11 18:03:03
2382,15,Jharkhand,3373071,2754830,618241,2021-05-11 18:03:03
2383,16,Karnataka,10963129,8718545,2244584,2021-05-11 18:03:03
2384,17,Kerala,8141289,6238776,1902513,2021-05-11 18:03:03
2385,18,Ladakh,121529,84630,36899,2021-05-11 18:03:03
2386,19,Lakshadweep,27372,20885,6487,2021-05-11 18:03:03
2387,20,Madhya Pradesh,8785173,7256989,1528184,2021-05-11 18:03:03
2388,21,Maharashtra,18793256,15144171,3649085,2021-05-11 18:03:03
2389,22,Manipur,350180,281137,69043,2021-05-11 18:03:03
2390,23,Meghalaya,366010,294637,71373,2021-05-11 18:03:03
2391,24,Mizoram,284591,234267,50324,2021-05-11 18:03:03
2392,25,Nagaland,226669,177071,49598,2021-05-11 18:03:03
2393,26,Odisha,6457266,5135650,1321616,2021-05-11 18:03:03
2394,27,Puducherry,223390,178838,44552,2021-05-11 18:03:03
2395,28,Punjab,4065354,3392970,672384,2021-05-11 18:03:03
2396,29,Rajasthan,14626660,11777805,2848855,2021-05-11 18:03:03
2397,30,Sikkim,222448,165440,57008,2021-05-11 18:03:03
2398,31,Tamil Nadu,6762623,4991388,1771235,2021-05-11 18:03:03
2399,32,Telangana,5406513,4422419,984094,2021-05-11 18:03:03
2400,33,Tripura,1465368,966997,498371,2021-05-11 18:03:03
2401,34,Uttar Pradesh,14073046,11141255,2931791,2021-05-11 18:03:03
2402,35,Uttarakhand,2511832,1850845,660987,2021-05-11 18:03:03
2403,36,West Bengal,12226878,8862487,3364391,2021-05-11 18:03:03
2404,37,Daman and Diu,54485,42784,11701,2021-05-11 18:03:03
2405,1,Andaman and Nicobar Islands,113622,99218,14404,2021-05-12 18:06:04
2406,2,Andhra Pradesh,7504394,5459958,2044436,2021-05-12 18:06:04
2407,3,Arunachal Pradesh,290786,214210,76576,2021-05-12 18:06:04
2408,4,Assam,3233331,2518410,714921,2021-05-12 18:06:04
2409,5,Bihar,8410850,6771938,1638912,2021-05-12 18:06:04
2410,6,Chandigarh,269353,199576,69777,2021-05-12 18:06:04
2411,7,Chhattisgarh,5996204,5010466,985738,2021-05-12 18:06:04
2412,8,Dadra and Nagar Haveli,51644,40751,10893,2021-05-12 18:06:04
2413,9,Delhi,4259338,3292311,967027,2021-05-12 18:06:04
2414,10,Goa,411191,322251,88940,2021-05-12 18:06:04
2415,11,Gujarat,14767554,11041502,3726052,2021-05-12 18:06:04
2416,12,Haryana,4663197,3817367,845830,2021-05-12 18:06:04
2417,13,Himachal Pradesh,2141989,1740172,401817,2021-05-12 18:06:04
2418,14,Jammu and Kashmir,2806013,2286567,519446,2021-05-12 18:06:04
2419,15,Jharkhand,3402653,2769962,632691,2021-05-12 18:06:04
2420,16,Karnataka,11102044,8792803,2309241,2021-05-12 18:06:04
2421,17,Kerala,8185506,6257014,1928492,2021-05-12 18:06:04
2422,18,Ladakh,122218,85240,36978,2021-05-12 18:06:04
2423,19,Lakshadweep,28102,21348,6754,2021-05-12 18:06:04
2424,20,Madhya Pradesh,8923121,7335386,1587735,2021-05-12 18:06:04
2425,21,Maharashtra,19139375,15322754,3816621,2021-05-12 18:06:04
2426,22,Manipur,358501,289255,69246,2021-05-12 18:06:04
2427,23,Meghalaya,376361,304094,72267,2021-05-12 18:06:04
2428,24,Mizoram,286159,235691,50468,2021-05-12 18:06:04
2429,25,Nagaland,229033,178737,50296,2021-05-12 18:06:04
2430,26,Odisha,6522664,5170331,1352333,2021-05-12 18:06:04
2431,27,Puducherry,225487,179489,45998,2021-05-12 18:06:04
2432,28,Punjab,4117718,3430867,686851,2021-05-12 18:06:04
2433,29,Rajasthan,14811519,11907840,2903679,2021-05-12 18:06:04
2434,30,Sikkim,223154,165669,57485,2021-05-12 18:06:04
2435,31,Tamil Nadu,6851406,5037596,1813810,2021-05-12 18:06:04
2436,32,Telangana,5440783,4432324,1008459,2021-05-12 18:06:04
2437,33,Tripura,1469744,968790,500954,2021-05-12 18:06:04
2438,34,Uttar Pradesh,14300912,11291626,3009286,2021-05-12 18:06:04
2439,35,Uttarakhand,2546600,1880013,666587,2021-05-12 18:06:04
2440,36,West Bengal,12408070,8890679,3517391,2021-05-12 18:06:04
2441,37,Daman and Diu,54981,43040,11941,2021-05-12 18:06:04
2442,1,Andaman and Nicobar Islands,114400,99602,14798,2021-05-13 18:01:39
2443,2,Andhra Pradesh,7551945,5470083,2081862,2021-05-13 18:01:39
2444,3,Arunachal Pradesh,293469,216168,77301,2021-05-13 18:01:39
2445,4,Assam,3280423,2556294,724129,2021-05-13 18:01:39
2446,5,Bihar,8568033,6907777,1660256,2021-05-13 18:01:39
2447,6,Chandigarh,273766,202829,70937,2021-05-13 18:01:39
2448,7,Chhattisgarh,6046459,5028824,1017635,2021-05-13 18:01:39
2449,8,Dadra and Nagar Haveli,52954,41699,11255,2021-05-13 18:01:39
2450,9,Delhi,4385905,3378261,1007644,2021-05-13 18:01:39
2451,10,Goa,418484,327646,90838,2021-05-13 18:01:39
2452,11,Gujarat,14975803,11145747,3830056,2021-05-13 18:01:39
2453,12,Haryana,4765647,3886385,879262,2021-05-13 18:01:39
2454,13,Himachal Pradesh,2175417,1757908,417509,2021-05-13 18:01:39
2455,14,Jammu and Kashmir,2811983,2290511,521472,2021-05-13 18:01:39
2456,15,Jharkhand,3428810,2782611,646199,2021-05-13 18:01:39
2457,16,Karnataka,11205478,8851449,2354029,2021-05-13 18:01:39
2458,17,Kerala,8212961,6267551,1945410,2021-05-13 18:01:39
2459,18,Ladakh,122800,85688,37112,2021-05-13 18:01:39
2460,19,Lakshadweep,28229,21428,6801,2021-05-13 18:01:39
2461,20,Madhya Pradesh,9034702,7402933,1631769,2021-05-13 18:01:39
2462,21,Maharashtra,19530640,15499282,4031358,2021-05-13 18:01:39
2463,22,Manipur,364547,295024,69523,2021-05-13 18:01:39
2464,23,Meghalaya,386756,313442,73314,2021-05-13 18:01:39
2465,24,Mizoram,288186,237420,50766,2021-05-13 18:01:39
2466,25,Nagaland,232245,180874,51371,2021-05-13 18:01:39
2467,26,Odisha,6575980,5202998,1372982,2021-05-13 18:01:39
2468,27,Puducherry,228252,180489,47763,2021-05-13 18:01:39
2469,28,Punjab,4157568,3460222,697346,2021-05-13 18:01:39
2470,29,Rajasthan,14934512,11987039,2947473,2021-05-13 18:01:39
2471,30,Sikkim,224984,165948,59036,2021-05-13 18:01:39
2472,31,Tamil Nadu,6951309,5092140,1859169,2021-05-13 18:01:39
2473,32,Telangana,5479812,4442464,1037348,2021-05-13 18:01:39
2474,33,Tripura,1479866,974828,505038,2021-05-13 18:01:39
2475,34,Uttar Pradesh,14581474,11465614,3115860,2021-05-13 18:01:39
2476,35,Uttarakhand,2578678,1907366,671312,2021-05-13 18:01:39
2477,36,West Bengal,12562690,8916777,3645913,2021-05-13 18:01:39
2478,37,Daman and Diu,56679,44269,12410,2021-05-13 18:01:39
2479,1,Andaman and Nicobar Islands,114498,99690,14808,2021-05-14 18:01:36
2480,2,Andhra Pradesh,7570886,5474544,2096342,2021-05-14 18:01:36
2481,3,Arunachal Pradesh,295034,217389,77645,2021-05-14 18:01:36
2482,4,Assam,3305992,2578539,727453,2021-05-14 18:01:36
2483,5,Bihar,8713263,7038183,1675080,2021-05-14 18:01:36
2484,6,Chandigarh,278699,206572,72127,2021-05-14 18:01:36
2485,7,Chhattisgarh,6095570,5044873,1050697,2021-05-14 18:01:36
2486,8,Dadra and Nagar Haveli,54475,42759,11716,2021-05-14 18:01:36
2487,9,Delhi,4390592,3381649,1008943,2021-05-14 18:01:36
2488,10,Goa,425521,332990,92531,2021-05-14 18:01:36
2489,11,Gujarat,15019896,11180770,3839126,2021-05-14 18:01:36
2490,12,Haryana,4833697,3931468,902229,2021-05-14 18:01:36
2491,13,Himachal Pradesh,2191401,1767255,424146,2021-05-14 18:01:36
2492,14,Jammu and Kashmir,2829044,2301414,527630,2021-05-14 18:01:36
2493,15,Jharkhand,3480054,2825315,654739,2021-05-14 18:01:36
2494,16,Karnataka,11296508,8885120,2411388,2021-05-14 18:01:36
2495,17,Kerala,8259812,6290354,1969458,2021-05-14 18:01:36
2496,18,Ladakh,122800,85688,37112,2021-05-14 18:01:36
2497,19,Lakshadweep,28241,21440,6801,2021-05-14 18:01:36
2498,20,Madhya Pradesh,9037120,7403682,1633438,2021-05-14 18:01:36
2499,21,Maharashtra,19703138,15571915,4131223,2021-05-14 18:01:36
2500,22,Manipur,370000,300409,69591,2021-05-14 18:01:36
2501,23,Meghalaya,395450,321576,73874,2021-05-14 18:01:36
2502,24,Mizoram,288999,238093,50906,2021-05-14 18:01:36
2503,25,Nagaland,233433,181746,51687,2021-05-14 18:01:36
2504,26,Odisha,6625243,5229023,1396220,2021-05-14 18:01:36
2505,27,Puducherry,230849,181667,49182,2021-05-14 18:01:36
2506,28,Punjab,4176283,3474171,702112,2021-05-14 18:01:36
2507,29,Rajasthan,14991949,12027499,2964450,2021-05-14 18:01:36
2508,30,Sikkim,225702,166119,59583,2021-05-14 18:01:36
2509,31,Tamil Nadu,7009930,5126070,1883860,2021-05-14 18:01:36
2510,32,Telangana,5513553,4450029,1063524,2021-05-14 18:01:36
2511,33,Tripura,1486004,980319,505685,2021-05-14 18:01:36
2512,34,Uttar Pradesh,14771189,11590929,3180260,2021-05-14 18:01:36
2513,35,Uttarakhand,2613490,1937336,676154,2021-05-14 18:01:36
2514,36,West Bengal,12609247,8929070,3680177,2021-05-14 18:01:36
2515,37,Daman and Diu,58851,45797,13054,2021-05-14 18:01:36
2516,1,Andaman and Nicobar Islands,115188,100058,15130,2021-05-15 18:13:28
2517,2,Andhra Pradesh,7651927,5484714,2167213,2021-05-15 18:13:28
2518,3,Arunachal Pradesh,296640,218759,77881,2021-05-15 18:13:28
2519,4,Assam,3362553,2631676,730877,2021-05-15 18:13:28
2520,5,Bihar,8869524,7180068,1689456,2021-05-15 18:13:28
2521,6,Chandigarh,284834,211162,73672,2021-05-15 18:13:28
2522,7,Chhattisgarh,6138265,5058803,1079462,2021-05-15 18:13:28
2523,8,Dadra and Nagar Haveli,56097,44198,11899,2021-05-15 18:13:28
2524,9,Delhi,4511407,3464560,1046847,2021-05-15 18:13:28
2525,10,Goa,436458,342243,94215,2021-05-15 18:13:28
2526,11,Gujarat,15055582,11213044,3842538,2021-05-15 18:13:28
2527,12,Haryana,4893748,3977395,916353,2021-05-15 18:13:28
2528,13,Himachal Pradesh,2217221,1784546,432675,2021-05-15 18:13:28
2529,14,Jammu and Kashmir,2846293,2313307,532986,2021-05-15 18:13:28
2530,15,Jharkhand,3541498,2876996,664502,2021-05-15 18:13:28
2531,16,Karnataka,11424456,8927204,2497252,2021-05-15 18:13:28
2532,17,Kerala,8417840,6426197,1991643,2021-05-15 18:13:28
2533,18,Ladakh,123897,86645,37252,2021-05-15 18:13:28
2534,19,Lakshadweep,28258,21452,6806,2021-05-15 18:13:28
2535,20,Madhya Pradesh,9163547,7472841,1690706,2021-05-15 18:13:28
2536,21,Maharashtra,19912961,15706411,4206550,2021-05-15 18:13:28
2537,22,Manipur,376997,307272,69725,2021-05-15 18:13:28
2538,23,Meghalaya,400823,326762,74061,2021-05-15 18:13:28
2539,24,Mizoram,289770,238803,50967,2021-05-15 18:13:28
2540,25,Nagaland,233825,182048,51777,2021-05-15 18:13:28
2541,26,Odisha,6661562,5256185,1405377,2021-05-15 18:13:28
2542,27,Puducherry,233493,183038,50455,2021-05-15 18:13:28
2543,28,Punjab,4195166,3488899,706267,2021-05-15 18:13:28
2544,29,Rajasthan,15135482,12151403,2984079,2021-05-15 18:13:28
2545,30,Sikkim,225794,166200,59594,2021-05-15 18:13:28
2546,31,Tamil Nadu,7074066,5162834,1911232,2021-05-15 18:13:28
2547,32,Telangana,5513738,4450028,1063710,2021-05-15 18:13:28
2548,33,Tripura,1492191,985530,506661,2021-05-15 18:13:28
2549,34,Uttar Pradesh,14983606,11723371,3260235,2021-05-15 18:13:28
2550,35,Uttarakhand,2645339,1964930,680409,2021-05-15 18:13:28
2551,36,West Bengal,12673069,8955081,3717988,2021-05-15 18:13:28
2552,37,Daman and Diu,61421,47449,13972,2021-05-15 18:13:28
2553,1,Andaman and Nicobar Islands,115188,100058,15130,2021-05-16 18:05:12
2554,2,Andhra Pradesh,7664356,5487757,2176599,2021-05-16 18:05:12
2555,3,Arunachal Pradesh,297055,219171,77884,2021-05-16 18:05:12
2556,4,Assam,3401496,2670104,731392,2021-05-16 18:05:12
2557,5,Bihar,8994996,7303994,1691002,2021-05-16 18:05:12
2558,6,Chandigarh,285946,212260,73686,2021-05-16 18:05:12
2559,7,Chhattisgarh,6142785,5062151,1080634,2021-05-16 18:05:12
2560,8,Dadra and Nagar Haveli,57471,45566,11905,2021-05-16 18:05:12
2561,9,Delhi,4603220,3544850,1058370,2021-05-16 18:05:12
2562,10,Goa,438881,344615,94266,2021-05-16 18:05:12
2563,11,Gujarat,15085762,11243101,3842661,2021-05-16 18:05:12
2564,12,Haryana,4937347,4019157,918190,2021-05-16 18:05:12
2565,13,Himachal Pradesh,2220769,1787942,432827,2021-05-16 18:05:12
2566,14,Jammu and Kashmir,2854854,2321690,533164,2021-05-16 18:05:12
2567,15,Jharkhand,3585174,2919090,666084,2021-05-16 18:05:12
2568,16,Karnataka,11448846,8942960,2505886,2021-05-16 18:05:12
2569,17,Kerala,8451480,6454137,1997343,2021-05-16 18:05:12
2570,18,Ladakh,123897,86645,37252,2021-05-16 18:05:12
2571,19,Lakshadweep,28282,21472,6810,2021-05-16 18:05:12
2572,20,Madhya Pradesh,9164574,7473284,1691290,2021-05-16 18:05:12
2573,21,Maharashtra,19985484,15756833,4228651,2021-05-16 18:05:12
2574,22,Manipur,377312,307585,69727,2021-05-16 18:05:12
2575,23,Meghalaya,403743,329682,74061,2021-05-16 18:05:12
2576,24,Mizoram,289783,238816,50967,2021-05-16 18:05:12
2577,25,Nagaland,234090,182306,51784,2021-05-16 18:05:12
2578,26,Odisha,6662987,5257596,1405391,2021-05-16 18:05:12
2579,27,Puducherry,234107,183604,50503,2021-05-16 18:05:12
2580,28,Punjab,4200672,3493453,707219,2021-05-16 18:05:12
2581,29,Rajasthan,15249948,12264148,2985800,2021-05-16 18:05:12
2582,30,Sikkim,226156,166562,59594,2021-05-16 18:05:12
2583,31,Tamil Nadu,7088176,5172965,1915211,2021-05-16 18:05:12
2584,32,Telangana,5513723,4450013,1063710,2021-05-16 18:05:12
2585,33,Tripura,1492618,985851,506767,2021-05-16 18:05:12
2586,34,Uttar Pradesh,14984918,11724458,3260460,2021-05-16 18:05:12
2587,35,Uttarakhand,2663086,1982530,680556,2021-05-16 18:05:12
2588,36,West Bengal,12678649,8958736,3719913,2021-05-16 18:05:12
2589,37,Daman and Diu,63175,49193,13982,2021-05-16 18:05:12
2590,1,Andaman and Nicobar Islands,115627,100492,15135,2021-05-17 18:07:35
2591,2,Andhra Pradesh,7731254,5504954,2226300,2021-05-17 18:07:35
2592,3,Arunachal Pradesh,302578,224664,77914,2021-05-17 18:07:35
2593,4,Assam,3471991,2730754,741237,2021-05-17 18:07:35
2594,5,Bihar,9108969,7411900,1697069,2021-05-17 18:07:35
2595,6,Chandigarh,290561,216622,73939,2021-05-17 18:07:35
2596,7,Chhattisgarh,6149696,5067225,1082471,2021-05-17 18:07:35
2597,8,Dadra and Nagar Haveli,59504,47599,11905,2021-05-17 18:07:35
2598,9,Delhi,4717683,3639716,1077967,2021-05-17 18:07:35
2599,10,Goa,444923,350557,94366,2021-05-17 18:07:35
2600,11,Gujarat,15086042,11243305,3842737,2021-05-17 18:07:35
2601,12,Haryana,5000446,4079084,921362,2021-05-17 18:07:35
2602,13,Himachal Pradesh,2243890,1810997,432893,2021-05-17 18:07:35
2603,14,Jammu and Kashmir,2869473,2335697,533776,2021-05-17 18:07:35
2604,15,Jharkhand,3640643,2972741,667902,2021-05-17 18:07:35
2605,16,Karnataka,11543880,9017346,2526534,2021-05-17 18:07:35
2606,17,Kerala,8519852,6510777,2009075,2021-05-17 18:07:35
2607,18,Ladakh,124756,87501,37255,2021-05-17 18:07:35
2608,19,Lakshadweep,28390,21562,6828,2021-05-17 18:07:35
2609,20,Madhya Pradesh,9258467,7547349,1711118,2021-05-17 18:07:35
2610,21,Maharashtra,20090425,15833287,4257138,2021-05-17 18:07:35
2611,22,Manipur,386041,316243,69798,2021-05-17 18:07:35
2612,23,Meghalaya,410381,336289,74092,2021-05-17 18:07:35
2613,24,Mizoram,291676,240707,50969,2021-05-17 18:07:35
2614,25,Nagaland,238157,186359,51798,2021-05-17 18:07:35
2615,26,Odisha,6723547,5310623,1412924,2021-05-17 18:07:35
2616,27,Puducherry,235311,184667,50644,2021-05-17 18:07:35
2617,28,Punjab,4209769,3500885,708884,2021-05-17 18:07:35
2618,29,Rajasthan,15414928,12424705,2990223,2021-05-17 18:07:35
2619,30,Sikkim,226891,167276,59615,2021-05-17 18:07:35
2620,31,Tamil Nadu,7145700,5216811,1928889,2021-05-17 18:07:35
2621,32,Telangana,5514512,4450594,1063918,2021-05-17 18:07:35
2622,33,Tripura,1501848,995017,506831,2021-05-17 18:07:35
2623,34,Uttar Pradesh,15222236,11943385,3278851,2021-05-17 18:07:35
2624,35,Uttarakhand,2691931,2011224,680707,2021-05-17 18:07:35
2625,36,West Bengal,12741310,9001376,3739934,2021-05-17 18:07:35
2626,37,Daman and Diu,63916,49928,13988,2021-05-17 18:07:35
2627,1,Andaman and Nicobar Islands,115911,100773,15138,2021-05-18 18:01:37
2628,2,Andhra Pradesh,7799705,5518465,2281240,2021-05-18 18:01:37
2629,3,Arunachal Pradesh,308245,230286,77959,2021-05-18 18:01:37
2630,4,Assam,3531930,2782676,749254,2021-05-18 18:01:37
2631,5,Bihar,9188143,7483076,1705067,2021-05-18 18:01:37
2632,6,Chandigarh,294430,220312,74118,2021-05-18 18:01:37
2633,7,Chhattisgarh,6155825,5072140,1083685,2021-05-18 18:01:37
2634,8,Dadra and Nagar Haveli,59504,47599,11905,2021-05-18 18:01:37
2635,9,Delhi,4824666,3729586,1095080,2021-05-18 18:01:37
2636,10,Goa,451943,357502,94441,2021-05-18 18:01:37
2637,11,Gujarat,15086347,11243561,3842786,2021-05-18 18:01:37
2638,12,Haryana,5065275,4140970,924305,2021-05-18 18:01:37
2639,13,Himachal Pradesh,2265500,1832502,432998,2021-05-18 18:01:37
2640,14,Jammu and Kashmir,2882672,2348544,534128,2021-05-18 18:01:37
2641,15,Jharkhand,3692552,3023461,669091,2021-05-18 18:01:37
2642,16,Karnataka,11629177,9091077,2538100,2021-05-18 18:01:37
2643,17,Kerala,8573567,6556628,2016939,2021-05-18 18:01:37
2644,18,Ladakh,125747,88488,37259,2021-05-18 18:01:37
2645,19,Lakshadweep,28703,21866,6837,2021-05-18 18:01:37
2646,20,Madhya Pradesh,9264811,7551243,1713568,2021-05-18 18:01:37
2647,21,Maharashtra,20201111,15923242,4277869,2021-05-18 18:01:37
2648,22,Manipur,390976,321100,69876,2021-05-18 18:01:37
2649,23,Meghalaya,415533,341428,74105,2021-05-18 18:01:37
2650,24,Mizoram,294300,243325,50975,2021-05-18 18:01:37
2651,25,Nagaland,243561,191742,51819,2021-05-18 18:01:37
2652,26,Odisha,6830272,5410278,1419994,2021-05-18 18:01:37
2653,27,Puducherry,236280,185565,50715,2021-05-18 18:01:37
2654,28,Punjab,4218012,3506609,711403,2021-05-18 18:01:37
2655,29,Rajasthan,15544817,12550082,2994735,2021-05-18 18:01:37
2656,30,Sikkim,227622,168003,59619,2021-05-18 18:01:37
2657,31,Tamil Nadu,7194563,5255610,1938953,2021-05-18 18:01:37
2658,32,Telangana,5516590,4451311,1065279,2021-05-18 18:01:37
2659,33,Tripura,1512008,1005122,506886,2021-05-18 18:01:37
2660,34,Uttar Pradesh,15436461,12144409,3292052,2021-05-18 18:01:37
2661,35,Uttarakhand,2715141,2034375,680766,2021-05-18 18:01:37
2662,36,West Bengal,12805341,9046876,3758465,2021-05-18 18:01:37
2663,37,Daman and Diu,64361,50368,13993,2021-05-18 18:01:37
2664,1,Andaman and Nicobar Islands,116427,101277,15150,2021-05-19 18:05:13
2665,2,Andhra Pradesh,7835404,5529872,2305532,2021-05-19 18:05:13
2666,3,Arunachal Pradesh,313429,235462,77967,2021-05-19 18:05:13
2667,4,Assam,3569472,2815640,753832,2021-05-19 18:05:13
2668,5,Bihar,9244503,7533234,1711269,2021-05-19 18:05:13
2669,6,Chandigarh,298281,224068,74213,2021-05-19 18:05:13
2670,7,Chhattisgarh,6162226,5077038,1085188,2021-05-19 18:05:13
2671,8,Dadra and Nagar Haveli,60894,48988,11906,2021-05-19 18:05:13
2672,9,Delhi,4893993,3791772,1102221,2021-05-19 18:05:13
2673,10,Goa,459632,365111,94521,2021-05-19 18:05:13
2674,11,Gujarat,15087757,11244920,3842837,2021-05-19 18:05:13
2675,12,Haryana,5118705,4191994,926711,2021-05-19 18:05:13
2676,13,Himachal Pradesh,2281222,1848161,433061,2021-05-19 18:05:13
2677,14,Jammu and Kashmir,2890348,2356090,534258,2021-05-19 18:05:13
2678,15,Jharkhand,3743211,3072388,670823,2021-05-19 18:05:13
2679,16,Karnataka,11714719,9162909,2551810,2021-05-19 18:05:13
2680,17,Kerala,8591102,6571984,2019118,2021-05-19 18:05:13
2681,18,Ladakh,126974,89715,37259,2021-05-19 18:05:13
2682,19,Lakshadweep,28943,22086,6857,2021-05-19 18:05:13
2683,20,Madhya Pradesh,9405542,7678925,1726617,2021-05-19 18:05:13
2684,21,Maharashtra,20305921,16000236,4305685,2021-05-19 18:05:13
2685,22,Manipur,399475,329532,69943,2021-05-19 18:05:13
2686,23,Meghalaya,419281,345160,74121,2021-05-19 18:05:13
2687,24,Mizoram,297576,246598,50978,2021-05-19 18:05:13
2688,25,Nagaland,245648,193820,51828,2021-05-19 18:05:13
2689,26,Odisha,6905443,5478370,1427073,2021-05-19 18:05:13
2690,27,Puducherry,237296,186539,50757,2021-05-19 18:05:13
2691,28,Punjab,4239354,3526147,713207,2021-05-19 18:05:13
2692,29,Rajasthan,15625438,12624961,3000477,2021-05-19 18:05:13
2693,30,Sikkim,229107,169488,59619,2021-05-19 18:05:13
2694,31,Tamil Nadu,7238986,5292027,1946959,2021-05-19 18:05:13
2695,32,Telangana,5519773,4451824,1067949,2021-05-19 18:05:13
2696,33,Tripura,1520712,1013813,506899,2021-05-19 18:05:13
2697,34,Uttar Pradesh,15621166,12319537,3301629,2021-05-19 18:05:13
2698,35,Uttarakhand,2727448,2046650,680798,2021-05-19 18:05:13
2699,36,West Bengal,12869283,9095356,3773927,2021-05-19 18:05:13
2700,37,Daman and Diu,65909,51914,13995,2021-05-19 18:05:13
2701,1,Andaman and Nicobar Islands,117180,102027,15153,2021-05-20 18:03:15
2702,2,Andhra Pradesh,7858242,5540108,2318134,2021-05-20 18:03:15
2703,3,Arunachal Pradesh,318150,240168,77982,2021-05-20 18:03:15
2704,4,Assam,3620350,2859912,760438,2021-05-20 18:03:15
2705,5,Bihar,9364319,7649684,1714635,2021-05-20 18:03:15
2706,6,Chandigarh,302065,227748,74317,2021-05-20 18:03:15
2707,7,Chhattisgarh,6169020,5081726,1087294,2021-05-20 18:03:15
2708,8,Dadra and Nagar Haveli,63617,51709,11908,2021-05-20 18:03:15
2709,9,Delhi,4972927,3849484,1123443,2021-05-20 18:03:15
2710,10,Goa,466522,371961,94561,2021-05-20 18:03:15
2711,11,Gujarat,15178758,11322050,3856708,2021-05-20 18:03:15
2712,12,Haryana,5198818,4267171,931647,2021-05-20 18:03:15
2713,13,Himachal Pradesh,2304113,1871031,433082,2021-05-20 18:03:15
2714,14,Jammu and Kashmir,2905453,2370453,535000,2021-05-20 18:03:15
2715,15,Jharkhand,3791168,3118200,672968,2021-05-20 18:03:15
2716,16,Karnataka,11800829,9228494,2572335,2021-05-20 18:03:15
2717,17,Kerala,8599407,6579668,2019739,2021-05-20 18:03:15
2718,18,Ladakh,128323,91064,37259,2021-05-20 18:03:15
2719,19,Lakshadweep,29039,22167,6872,2021-05-20 18:03:15
2720,20,Madhya Pradesh,9534535,7798981,1735554,2021-05-20 18:03:15
2721,21,Maharashtra,20469090,16125493,4343597,2021-05-20 18:03:15
2722,22,Manipur,403292,333308,69984,2021-05-20 18:03:15
2723,23,Meghalaya,424013,349885,74128,2021-05-20 18:03:15
2724,24,Mizoram,301229,250250,50979,2021-05-20 18:03:15
2725,25,Nagaland,246683,194835,51848,2021-05-20 18:03:15
2726,26,Odisha,6965104,5532870,1432234,2021-05-20 18:03:15
2727,27,Puducherry,239946,189131,50815,2021-05-20 18:03:15
2728,28,Punjab,4277807,3561644,716163,2021-05-20 18:03:15
2729,29,Rajasthan,15709931,12703604,3006327,2021-05-20 18:03:15
2730,30,Sikkim,230980,171357,59623,2021-05-20 18:03:15
2731,31,Tamil Nadu,7281385,5328713,1952672,2021-05-20 18:03:15
2732,32,Telangana,5523167,4452572,1070595,2021-05-20 18:03:15
2733,33,Tripura,1527785,1020857,506928,2021-05-20 18:03:15
2734,34,Uttar Pradesh,15815757,12501172,3314585,2021-05-20 18:03:15
2735,35,Uttarakhand,2744103,2063198,680905,2021-05-20 18:03:15
2736,36,West Bengal,12933777,9145955,3787822,2021-05-20 18:03:15
2737,37,Daman and Diu,70001,56002,13999,2021-05-20 18:03:15
2738,1,Andaman and Nicobar Islands,117950,102795,15155,2021-05-21 18:05:35
2739,2,Andhra Pradesh,7893553,5553155,2340398,2021-05-21 18:05:35
2740,3,Arunachal Pradesh,321367,243375,77992,2021-05-21 18:05:35
2741,4,Assam,3665677,2898356,767321,2021-05-21 18:05:35
2742,5,Bihar,9461805,7740229,1721576,2021-05-21 18:05:35
2743,6,Chandigarh,306407,231985,74422,2021-05-21 18:05:35
2744,7,Chhattisgarh,6175698,5086605,1089093,2021-05-21 18:05:35
2745,8,Dadra and Nagar Haveli,66570,54662,11908,2021-05-21 18:05:35
2746,9,Delhi,5023830,3891570,1132260,2021-05-21 18:05:35
2747,10,Goa,475385,380741,94644,2021-05-21 18:05:35
2748,11,Gujarat,15283762,11411337,3872425,2021-05-21 18:05:35
2749,12,Haryana,5285929,4347428,938501,2021-05-21 18:05:35
2750,13,Himachal Pradesh,2323021,1889844,433177,2021-05-21 18:05:35
2751,14,Jammu and Kashmir,2919084,2383345,535739,2021-05-21 18:05:35
2752,15,Jharkhand,3840095,3165104,674991,2021-05-21 18:05:35
2753,16,Karnataka,11909375,9307704,2601671,2021-05-21 18:05:35
2754,17,Kerala,8614955,6594484,2020471,2021-05-21 18:05:35
2755,18,Ladakh,130333,93074,37259,2021-05-21 18:05:35
2756,19,Lakshadweep,29532,22620,6912,2021-05-21 18:05:35
2757,20,Madhya Pradesh,9633951,7890679,1743272,2021-05-21 18:05:35
2758,21,Maharashtra,20594480,16228107,4366373,2021-05-21 18:05:35
2759,22,Manipur,409970,339942,70028,2021-05-21 18:05:35
2760,23,Meghalaya,429754,355604,74150,2021-05-21 18:05:35
2761,24,Mizoram,303182,252199,50983,2021-05-21 18:05:35
2762,25,Nagaland,247248,195395,51853,2021-05-21 18:05:35
2763,26,Odisha,7016023,5579335,1436688,2021-05-21 18:05:35
2764,27,Puducherry,242269,191439,50830,2021-05-21 18:05:35
2765,28,Punjab,4315504,3594993,720511,2021-05-21 18:05:35
2766,29,Rajasthan,15819046,12802928,3016118,2021-05-21 18:05:35
2767,30,Sikkim,232718,173083,59635,2021-05-21 18:05:35
2768,31,Tamil Nadu,7324578,5366890,1957688,2021-05-21 18:05:35
2769,32,Telangana,5523983,4453036,1070947,2021-05-21 18:05:35
2770,33,Tripura,1535202,1028249,506953,2021-05-21 18:05:35
2771,34,Uttar Pradesh,16034055,12704173,3329882,2021-05-21 18:05:35
2772,35,Uttarakhand,2759084,2078139,680945,2021-05-21 18:05:35
2773,36,West Bengal,13005642,9202281,3803361,2021-05-21 18:05:35
2774,37,Daman and Diu,73458,59459,13999,2021-05-21 18:05:35
2775,1,Andaman and Nicobar Islands,118761,103605,15156,2021-05-22 18:05:17
2776,2,Andhra Pradesh,7912387,5564391,2347996,2021-05-22 18:05:17
2777,3,Arunachal Pradesh,323227,245155,78072,2021-05-22 18:05:17
2778,4,Assam,3716057,2938534,777523,2021-05-22 18:05:17
2779,5,Bihar,9521985,7792418,1729567,2021-05-22 18:05:17
2780,6,Chandigarh,312342,237720,74622,2021-05-22 18:05:17
2781,7,Chhattisgarh,6183544,5092759,1090785,2021-05-22 18:05:17
2782,8,Dadra and Nagar Haveli,69803,57893,11910,2021-05-22 18:05:17
2783,9,Delhi,5089360,3937526,1151834,2021-05-22 18:05:17
2784,10,Goa,483932,389264,94668,2021-05-22 18:05:17
2785,11,Gujarat,15409941,11511819,3898122,2021-05-22 18:05:17
2786,12,Haryana,5357673,4411859,945814,2021-05-22 18:05:17
2787,13,Himachal Pradesh,2334590,1901363,433227,2021-05-22 18:05:17
2788,14,Jammu and Kashmir,2955599,2418186,537413,2021-05-22 18:05:17
2789,15,Jharkhand,3877535,3200833,676702,2021-05-22 18:05:17
2790,16,Karnataka,12024601,9407949,2616652,2021-05-22 18:05:17
2791,17,Kerala,8644286,6623770,2020516,2021-05-22 18:05:17
2792,18,Ladakh,132065,94806,37259,2021-05-22 18:05:17
2793,19,Lakshadweep,30027,23106,6921,2021-05-22 18:05:17
2794,20,Madhya Pradesh,9780872,8027754,1753118,2021-05-22 18:05:17
2795,21,Maharashtra,20721925,16334069,4387856,2021-05-22 18:05:17
2796,22,Manipur,413778,343712,70066,2021-05-22 18:05:17
2797,23,Meghalaya,434372,360219,74153,2021-05-22 18:05:17
2798,24,Mizoram,303183,252200,50983,2021-05-22 18:05:17
2799,25,Nagaland,247350,195495,51855,2021-05-22 18:05:17
2800,26,Odisha,7101313,5660062,1441251,2021-05-22 18:05:17
2801,27,Puducherry,244618,193758,50860,2021-05-22 18:05:17
2802,28,Punjab,4370081,3643665,726416,2021-05-22 18:05:17
2803,29,Rajasthan,15944507,12918452,3026055,2021-05-22 18:05:17
2804,30,Sikkim,234303,174666,59637,2021-05-22 18:05:17
2805,31,Tamil Nadu,7376373,5414511,1961862,2021-05-22 18:05:17
2806,32,Telangana,5526809,4453428,1073381,2021-05-22 18:05:17
2807,33,Tripura,1551548,1044553,506995,2021-05-22 18:05:17
2808,34,Uttar Pradesh,16250125,12905379,3344746,2021-05-22 18:05:17
2809,35,Uttarakhand,2772880,2091853,681027,2021-05-22 18:05:17
2810,36,West Bengal,13089001,9274023,3814978,2021-05-22 18:05:17
2811,37,Daman and Diu,76476,62477,13999,2021-05-22 18:05:17
2812,1,Andaman and Nicobar Islands,119144,103988,15156,2021-05-23 18:05:27
2813,2,Andhra Pradesh,7916378,5565733,2350645,2021-05-23 18:05:27
2814,3,Arunachal Pradesh,324050,245978,78072,2021-05-23 18:05:27
2815,4,Assam,3753634,2972649,780985,2021-05-23 18:05:27
2816,5,Bihar,9680320,7946125,1734195,2021-05-23 18:05:27
2817,6,Chandigarh,315428,240804,74624,2021-05-23 18:05:27
2818,7,Chhattisgarh,6188736,5097012,1091724,2021-05-23 18:05:27
2819,8,Dadra and Nagar Haveli,72133,60222,11911,2021-05-23 18:05:27
2820,9,Delhi,5094052,3941971,1152081,2021-05-23 18:05:27
2821,10,Goa,485580,390888,94692,2021-05-23 18:05:27
2822,11,Gujarat,15517112,11597065,3920047,2021-05-23 18:05:27
2823,12,Haryana,5391897,4440938,950959,2021-05-23 18:05:27
2824,13,Himachal Pradesh,2336775,1903536,433239,2021-05-23 18:05:27
2825,14,Jammu and Kashmir,2973267,2435205,538062,2021-05-23 18:05:27
2826,15,Jharkhand,3922615,3243983,678632,2021-05-23 18:05:27
2827,16,Karnataka,12090132,9468998,2621134,2021-05-23 18:05:27
2828,17,Kerala,8650242,6629730,2020512,2021-05-23 18:05:27
2829,18,Ladakh,132138,94879,37259,2021-05-23 18:05:27
2830,19,Lakshadweep,30955,24029,6926,2021-05-23 18:05:27
2831,20,Madhya Pradesh,9951909,8197104,1754805,2021-05-23 18:05:27
2832,21,Maharashtra,20764307,16372619,4391688,2021-05-23 18:05:27
2833,22,Manipur,413789,343723,70066,2021-05-23 18:05:27
2834,23,Meghalaya,435578,361425,74153,2021-05-23 18:05:27
2835,24,Mizoram,303183,252200,50983,2021-05-23 18:05:27
2836,25,Nagaland,247518,195663,51855,2021-05-23 18:05:27
2837,26,Odisha,7116956,5675546,1441410,2021-05-23 18:05:27
2838,27,Puducherry,246119,195225,50894,2021-05-23 18:05:27
2839,28,Punjab,4395456,3664829,730627,2021-05-23 18:05:27
2840,29,Rajasthan,16036022,13005682,3030340,2021-05-23 18:05:27
2841,30,Sikkim,234303,174666,59637,2021-05-23 18:05:27
2842,31,Tamil Nadu,7391558,5428460,1963098,2021-05-23 18:05:27
2843,32,Telangana,5527536,4453840,1073696,2021-05-23 18:05:27
2844,33,Tripura,1554306,1047297,507009,2021-05-23 18:05:27
2845,34,Uttar Pradesh,16257576,12912206,3345370,2021-05-23 18:05:27
2846,35,Uttarakhand,2783836,2102721,681115,2021-05-23 18:05:27
2847,36,West Bengal,13144491,9329037,3815454,2021-05-23 18:05:27
2848,37,Daman and Diu,78799,64800,13999,2021-05-23 18:05:27
2849,1,Andaman and Nicobar Islands,119595,104439,15156,2021-05-24 18:08:21
2850,2,Andhra Pradesh,8024718,5657995,2366723,2021-05-24 18:08:21
2851,3,Arunachal Pradesh,327082,248988,78094,2021-05-24 18:08:21
2852,4,Assam,3830285,3034072,796213,2021-05-24 18:08:21
2853,5,Bihar,9866976,8126352,1740624,2021-05-24 18:08:21
2854,6,Chandigarh,320496,245841,74655,2021-05-24 18:08:21
2855,7,Chhattisgarh,6195610,5102041,1093569,2021-05-24 18:08:21
2856,8,Dadra and Nagar Haveli,74912,62998,11914,2021-05-24 18:08:21
2857,9,Delhi,5149102,3982668,1166434,2021-05-24 18:08:21
2858,10,Goa,491327,396609,94718,2021-05-24 18:08:21
2859,11,Gujarat,15704348,11761583,3942765,2021-05-24 18:08:21
2860,12,Haryana,5488326,4532711,955615,2021-05-24 18:08:21
2861,13,Himachal Pradesh,2358360,1925094,433266,2021-05-24 18:08:21
2862,14,Jammu and Kashmir,3010302,2470849,539453,2021-05-24 18:08:21
2863,15,Jharkhand,3973018,3291812,681206,2021-05-24 18:08:21
2864,16,Karnataka,12245548,9612845,2632703,2021-05-24 18:08:21
2865,17,Kerala,8703636,6683008,2020628,2021-05-24 18:08:21
2866,18,Ladakh,134068,96803,37265,2021-05-24 18:08:21
2867,19,Lakshadweep,31277,24344,6933,2021-05-24 18:08:21
2868,20,Madhya Pradesh,10169763,8407261,1762502,2021-05-24 18:08:21
2869,21,Maharashtra,21017887,16609665,4408222,2021-05-24 18:08:21
2870,22,Manipur,420969,350862,70107,2021-05-24 18:08:21
2871,23,Meghalaya,440677,366498,74179,2021-05-24 18:08:21
2872,24,Mizoram,304935,253889,51046,2021-05-24 18:08:21
2873,25,Nagaland,253389,201530,51859,2021-05-24 18:08:21
2874,26,Odisha,7229151,5783351,1445800,2021-05-24 18:08:21
2875,27,Puducherry,248922,197993,50929,2021-05-24 18:08:21
2876,28,Punjab,4422727,3686610,736117,2021-05-24 18:08:21
2877,29,Rajasthan,16186104,13146017,3040087,2021-05-24 18:08:21
2878,30,Sikkim,235593,175956,59637,2021-05-24 18:08:21
2879,31,Tamil Nadu,7474454,5507425,1967029,2021-05-24 18:08:21
2880,32,Telangana,5530380,4454488,1075892,2021-05-24 18:08:21
2881,33,Tripura,1560658,1053533,507125,2021-05-24 18:08:21
2882,34,Uttar Pradesh,16545773,13182148,3363625,2021-05-24 18:08:21
2883,35,Uttarakhand,2807770,2126366,681404,2021-05-24 18:08:21
2884,36,West Bengal,13334204,9506821,3827383,2021-05-24 18:08:21
2885,37,Daman and Diu,81948,67947,14001,2021-05-24 18:08:21
2886,1,Andaman and Nicobar Islands,120282,105124,15158,2021-05-25 18:05:48
2887,2,Andhra Pradesh,8166344,5791214,2375130,2021-05-25 18:05:48
2888,3,Arunachal Pradesh,328603,250439,78164,2021-05-25 18:05:48
2889,4,Assam,3899916,3091356,808560,2021-05-25 18:05:48
2890,5,Bihar,9988332,8240378,1747954,2021-05-25 18:05:48
2891,6,Chandigarh,323442,248749,74693,2021-05-25 18:05:48
2892,7,Chhattisgarh,6201085,5105825,1095260,2021-05-25 18:05:48
2893,8,Dadra and Nagar Haveli,77345,65429,11916,2021-05-25 18:05:48
2894,9,Delhi,5193421,4016462,1176959,2021-05-25 18:05:48
2895,10,Goa,497181,402428,94753,2021-05-25 18:05:48
2896,11,Gujarat,15900599,11931871,3968728,2021-05-25 18:05:48
2897,12,Haryana,5559017,4597934,961083,2021-05-25 18:05:48
2898,13,Himachal Pradesh,2377024,1943660,433364,2021-05-25 18:05:48
2899,14,Jammu and Kashmir,3050429,2510207,540222,2021-05-25 18:05:48
2900,15,Jharkhand,4012657,3328296,684361,2021-05-25 18:05:48
2901,16,Karnataka,12412625,9770541,2642084,2021-05-25 18:05:48
2902,17,Kerala,8759511,6738756,2020755,2021-05-25 18:05:48
2903,18,Ladakh,136295,99029,37266,2021-05-25 18:05:48
2904,19,Lakshadweep,31319,24384,6935,2021-05-25 18:05:48
2905,20,Madhya Pradesh,10176375,8412895,1763480,2021-05-25 18:05:48
2906,21,Maharashtra,21218648,16796114,4422534,2021-05-25 18:05:48
2907,22,Manipur,424213,354051,70162,2021-05-25 18:05:48
2908,23,Meghalaya,446278,372072,74206,2021-05-25 18:05:48
2909,24,Mizoram,306514,255455,51059,2021-05-25 18:05:48
2910,25,Nagaland,259741,207870,51871,2021-05-25 18:05:48
2911,26,Odisha,7326713,5877676,1449037,2021-05-25 18:05:48
2912,27,Puducherry,251483,200518,50965,2021-05-25 18:05:48
2913,28,Punjab,4449190,3704777,744413,2021-05-25 18:05:48
2914,29,Rajasthan,16287498,13236341,3051157,2021-05-25 18:05:48
2915,30,Sikkim,236874,177233,59641,2021-05-25 18:05:48
2916,31,Tamil Nadu,7661549,5690314,1971235,2021-05-25 18:05:48
2917,32,Telangana,5589803,4462814,1126989,2021-05-25 18:05:48
2918,33,Tripura,1566076,1058834,507242,2021-05-25 18:05:48
2919,34,Uttar Pradesh,16819753,13439739,3380014,2021-05-25 18:05:48
2920,35,Uttarakhand,2829587,2147806,681781,2021-05-25 18:05:48
2921,36,West Bengal,13492652,9656754,3835898,2021-05-25 18:05:48
2922,37,Daman and Diu,85491,71487,14004,2021-05-25 18:05:48
2923,1,Andaman and Nicobar Islands,121091,105933,15158,2021-05-26 18:05:42
2924,2,Andhra Pradesh,8461529,6077616,2383913,2021-05-26 18:05:42
2925,3,Arunachal Pradesh,329432,251257,78175,2021-05-26 18:05:42
2926,4,Assam,3935244,3121530,813714,2021-05-26 18:05:42
2927,5,Bihar,10065595,8310988,1754607,2021-05-26 18:05:42
2928,6,Chandigarh,324892,250185,74707,2021-05-26 18:05:42
2929,7,Chhattisgarh,6207552,5110785,1096767,2021-05-26 18:05:42
2930,8,Dadra and Nagar Haveli,79616,67699,11917,2021-05-26 18:05:42
2931,9,Delhi,5227642,4047234,1180408,2021-05-26 18:05:42
2932,10,Goa,503102,408310,94792,2021-05-26 18:05:42
2933,11,Gujarat,16089605,12097201,3992404,2021-05-26 18:05:42
2934,12,Haryana,5611915,4646723,965192,2021-05-26 18:05:42
2935,13,Himachal Pradesh,2383944,1950539,433405,2021-05-26 18:05:42
2936,14,Jammu and Kashmir,3094819,2554228,540591,2021-05-26 18:05:42
2937,15,Jharkhand,4037120,3350619,686501,2021-05-26 18:05:42
2938,16,Karnataka,12592237,9939949,2652288,2021-05-26 18:05:42
2939,17,Kerala,8789986,6769141,2020845,2021-05-26 18:05:42
2940,18,Ladakh,138455,101189,37266,2021-05-26 18:05:42
2941,19,Lakshadweep,31381,24446,6935,2021-05-26 18:05:42
2942,20,Madhya Pradesh,10178607,8415029,1763578,2021-05-26 18:05:42
2943,21,Maharashtra,21357019,16923334,4433685,2021-05-26 18:05:42
2944,22,Manipur,435973,365796,70177,2021-05-26 18:05:42
2945,23,Meghalaya,449715,375505,74210,2021-05-26 18:05:42
2946,24,Mizoram,307169,256108,51061,2021-05-26 18:05:42
2947,25,Nagaland,260726,208841,51885,2021-05-26 18:05:42
2948,26,Odisha,7376805,5927554,1449251,2021-05-26 18:05:42
2949,27,Puducherry,254227,203231,50996,2021-05-26 18:05:42
2950,28,Punjab,4481306,3732646,748660,2021-05-26 18:05:42
2951,29,Rajasthan,16367039,13307749,3059290,2021-05-26 18:05:42
2952,30,Sikkim,237959,178318,59641,2021-05-26 18:05:42
2953,31,Tamil Nadu,7911989,5937641,1974348,2021-05-26 18:05:42
2954,32,Telangana,5653875,4477986,1175889,2021-05-26 18:05:42
2955,33,Tripura,1568299,1060987,507312,2021-05-26 18:05:42
2956,34,Uttar Pradesh,17077318,13683978,3393340,2021-05-26 18:05:42
2957,35,Uttarakhand,2838290,2156373,681917,2021-05-26 18:05:42
2958,36,West Bengal,13555397,9718255,3837142,2021-05-26 18:05:42
2959,37,Daman and Diu,89115,75106,14009,2021-05-26 18:05:42
2960,1,Andaman and Nicobar Islands,121709,106548,15161,2021-05-27 18:15:41
2961,2,Andhra Pradesh,9041704,6646329,2395375,2021-05-27 18:15:41
2962,3,Arunachal Pradesh,330440,252251,78189,2021-05-27 18:15:41
2963,4,Assam,3981993,3162795,819198,2021-05-27 18:15:41
2964,5,Bihar,10117956,8358233,1759723,2021-05-27 18:15:41
2965,6,Chandigarh,329825,255083,74742,2021-05-27 18:15:41
2966,7,Chhattisgarh,6211771,5113787,1097984,2021-05-27 18:15:41
2967,8,Dadra and Nagar Haveli,82070,70140,11930,2021-05-27 18:15:41
2968,9,Delhi,5267047,4081179,1185868,2021-05-27 18:15:41
2969,10,Goa,508929,414099,94830,2021-05-27 18:15:41
2970,11,Gujarat,16288663,12268283,4020380,2021-05-27 18:15:41
2971,12,Haryana,5687065,4713611,973454,2021-05-27 18:15:41
2972,13,Himachal Pradesh,2405470,1972050,433420,2021-05-27 18:15:41
2973,14,Jammu and Kashmir,3155084,2613888,541196,2021-05-27 18:15:41
2974,15,Jharkhand,4053662,3365244,688418,2021-05-27 18:15:41
2975,16,Karnataka,12825233,10154382,2670851,2021-05-27 18:15:41
2976,17,Kerala,8904101,6881455,2022646,2021-05-27 18:15:41
2977,18,Ladakh,144322,107045,37277,2021-05-27 18:15:41
2978,19,Lakshadweep,31425,24487,6938,2021-05-27 18:15:41
2979,20,Madhya Pradesh,10408724,8636598,1772126,2021-05-27 18:15:41
2980,21,Maharashtra,21646047,17185260,4460787,2021-05-27 18:15:41
2981,22,Manipur,439064,368847,70217,2021-05-27 18:15:41
2982,23,Meghalaya,455068,380832,74236,2021-05-27 18:15:41
2983,24,Mizoram,308604,257533,51071,2021-05-27 18:15:41
2984,25,Nagaland,261511,209613,51898,2021-05-27 18:15:41
2985,26,Odisha,7479267,6025065,1454202,2021-05-27 18:15:41
2986,27,Puducherry,257055,206019,51036,2021-05-27 18:15:41
2987,28,Punjab,4505316,3752653,752663,2021-05-27 18:15:41
2988,29,Rajasthan,16429435,13364123,3065312,2021-05-27 18:15:41
2989,30,Sikkim,238715,179072,59643,2021-05-27 18:15:41
2990,31,Tamil Nadu,8207581,6228601,1978980,2021-05-27 18:15:41
2991,32,Telangana,5704161,4495509,1208652,2021-05-27 18:15:41
2992,33,Tripura,1571248,1063836,507412,2021-05-27 18:15:41
2993,34,Uttar Pradesh,17358619,13951433,3407186,2021-05-27 18:15:41
2994,35,Uttarakhand,2857400,2175239,682161,2021-05-27 18:15:41
2995,36,West Bengal,13729758,9887171,3842587,2021-05-27 18:15:41
2996,37,Daman and Diu,92448,78434,14014,2021-05-27 18:15:41
2997,1,Andaman and Nicobar Islands,122466,107304,15162,2021-05-28 18:06:20
2998,2,Andhra Pradesh,9489427,7076681,2412746,2021-05-28 18:06:20
2999,3,Arunachal Pradesh,331507,253299,78208,2021-05-28 18:06:20
3000,4,Assam,4027267,3203860,823407,2021-05-28 18:06:20
3001,5,Bihar,10151854,8387279,1764575,2021-05-28 18:06:20
3002,6,Chandigarh,334628,259802,74826,2021-05-28 18:06:20
3003,7,Chhattisgarh,6221318,5121323,1099995,2021-05-28 18:06:20
3004,8,Dadra and Nagar Haveli,84517,72584,11933,2021-05-28 18:06:20
3005,9,Delhi,5298145,4109417,1188728,2021-05-28 18:06:20
3006,10,Goa,514993,420108,94885,2021-05-28 18:06:20
3007,11,Gujarat,16507080,12450671,4056409,2021-05-28 18:06:20
3008,12,Haryana,5750545,4770090,980455,2021-05-28 18:06:20
3009,13,Himachal Pradesh,2419146,1985604,433542,2021-05-28 18:06:20
3010,14,Jammu and Kashmir,3204397,2662545,541852,2021-05-28 18:06:20
3011,15,Jharkhand,4084905,3391607,693298,2021-05-28 18:06:20
3012,16,Karnataka,13092355,10393587,2698768,2021-05-28 18:06:20
3013,17,Kerala,9056319,7031368,2024951,2021-05-28 18:06:20
3014,18,Ladakh,150093,112815,37278,2021-05-28 18:06:20
3015,19,Lakshadweep,31668,24727,6941,2021-05-28 18:06:20
3016,20,Madhya Pradesh,10632301,8854641,1777660,2021-05-28 18:06:20
3017,21,Maharashtra,21922332,17435162,4487170,2021-05-28 18:06:20
3018,22,Manipur,444143,373870,70273,2021-05-28 18:06:20
3019,23,Meghalaya,459870,385589,74281,2021-05-28 18:06:20
3020,24,Mizoram,311404,260319,51085,2021-05-28 18:06:20
3021,25,Nagaland,262233,210313,51920,2021-05-28 18:06:20
3022,26,Odisha,7603679,6139653,1464026,2021-05-28 18:06:20
3023,27,Puducherry,260310,209222,51088,2021-05-28 18:06:20
3024,28,Punjab,4524772,3768228,756544,2021-05-28 18:06:20
3025,29,Rajasthan,16554851,13476249,3078602,2021-05-28 18:06:20
3026,30,Sikkim,238828,179180,59648,2021-05-28 18:06:20
3027,31,Tamil Nadu,8515668,6520216,1995452,2021-05-28 18:06:20
3028,32,Telangana,5807345,4577960,1229385,2021-05-28 18:06:20
3029,33,Tripura,1574604,1067115,507489,2021-05-28 18:06:20
3030,34,Uttar Pradesh,17668213,14243865,3424348,2021-05-28 18:06:20
3031,35,Uttarakhand,2875266,2192644,682622,2021-05-28 18:06:20
3032,36,West Bengal,13993316,10141025,3852291,2021-05-28 18:06:20
3033,37,Daman and Diu,96177,82159,14018,2021-05-28 18:06:20
3034,1,Andaman and Nicobar Islands,123483,108317,15166,2021-05-29 18:05:35
3035,2,Andhra Pradesh,9756270,7274735,2481535,2021-05-29 18:05:35
3036,3,Arunachal Pradesh,332717,254447,78270,2021-05-29 18:05:35
3037,4,Assam,4073879,3246700,827179,2021-05-29 18:05:35
3038,5,Bihar,10204573,8431414,1773159,2021-05-29 18:05:35
3039,6,Chandigarh,339601,264747,74854,2021-05-29 18:05:35
3040,7,Chhattisgarh,6229290,5127168,1102122,2021-05-29 18:05:35
3041,8,Dadra and Nagar Haveli,87418,75480,11938,2021-05-29 18:05:35
3042,9,Delhi,5352466,4148595,1203871,2021-05-29 18:05:35
3043,10,Goa,521480,426519,94961,2021-05-29 18:05:35
3044,11,Gujarat,16724256,12634113,4090143,2021-05-29 18:05:35
3045,12,Haryana,5804788,4816451,988337,2021-05-29 18:05:35
3046,13,Himachal Pradesh,2429862,1996254,433608,2021-05-29 18:05:35
3047,14,Jammu and Kashmir,3242705,2699856,542849,2021-05-29 18:05:35
3048,15,Jharkhand,4124267,3424365,699902,2021-05-29 18:05:35
3049,16,Karnataka,13346630,10625599,2721031,2021-05-29 18:05:35
3050,17,Kerala,9215371,7170607,2044764,2021-05-29 18:05:35
3051,18,Ladakh,154115,116836,37279,2021-05-29 18:05:35
3052,19,Lakshadweep,32136,25192,6944,2021-05-29 18:05:35
3053,20,Madhya Pradesh,10882668,9098436,1784232,2021-05-29 18:05:35
3054,21,Maharashtra,22230988,17709573,4521415,2021-05-29 18:05:35
3055,22,Manipur,451025,380689,70336,2021-05-29 18:05:35
3056,23,Meghalaya,463649,389328,74321,2021-05-29 18:05:35
3057,24,Mizoram,313383,262296,51087,2021-05-29 18:05:35
3058,25,Nagaland,262488,210558,51930,2021-05-29 18:05:35
3059,26,Odisha,7708912,6238288,1470624,2021-05-29 18:05:35
3060,27,Puducherry,263594,212447,51147,2021-05-29 18:05:35
3061,28,Punjab,4568745,3807020,761725,2021-05-29 18:05:35
3062,29,Rajasthan,16759793,13668689,3091104,2021-05-29 18:05:35
3063,30,Sikkim,238891,179238,59653,2021-05-29 18:05:35
3064,31,Tamil Nadu,8794771,6781739,2013032,2021-05-29 18:05:35
3065,32,Telangana,5918092,4672773,1245319,2021-05-29 18:05:35
3066,33,Tripura,1588209,1080636,507573,2021-05-29 18:05:35
3067,34,Uttar Pradesh,17994300,14544503,3449797,2021-05-29 18:05:35
3068,35,Uttarakhand,2891355,2208274,683081,2021-05-29 18:05:35
3069,36,West Bengal,14271067,10407006,3864061,2021-05-29 18:05:35
3070,37,Daman and Diu,99227,85207,14020,2021-05-29 18:05:35
3071,1,Andaman and Nicobar Islands,123725,108559,15166,2021-05-30 18:05:53
3072,2,Andhra Pradesh,9772924,7288465,2484459,2021-05-30 18:05:53
3073,3,Arunachal Pradesh,333067,254795,78272,2021-05-30 18:05:53
3074,4,Assam,4094193,3265432,828761,2021-05-30 18:05:53
3075,5,Bihar,10247415,8467861,1779554,2021-05-30 18:05:53
3076,6,Chandigarh,343466,268609,74857,2021-05-30 18:05:53
3077,7,Chhattisgarh,6233466,5130182,1103284,2021-05-30 18:05:53
3078,8,Dadra and Nagar Haveli,88514,76576,11938,2021-05-30 18:05:53
3079,9,Delhi,5362104,4157813,1204291,2021-05-30 18:05:53
3080,10,Goa,524372,429393,94979,2021-05-30 18:05:53
3081,11,Gujarat,16910245,12795634,4114611,2021-05-30 18:05:53
3082,12,Haryana,5832328,4841864,990464,2021-05-30 18:05:53
3083,13,Himachal Pradesh,2431191,1997579,433612,2021-05-30 18:05:53
3084,14,Jammu and Kashmir,3265442,2722017,543425,2021-05-30 18:05:53
3085,15,Jharkhand,4156776,3452239,704537,2021-05-30 18:05:53
3086,16,Karnataka,13439808,10709480,2730328,2021-05-30 18:05:53
3087,17,Kerala,9241456,7190905,2050551,2021-05-30 18:05:53
3088,18,Ladakh,154135,116856,37279,2021-05-30 18:05:53
3089,19,Lakshadweep,32818,25870,6948,2021-05-30 18:05:53
3090,20,Madhya Pradesh,10899947,9115504,1784443,2021-05-30 18:05:53
3091,21,Maharashtra,22319656,17787436,4532220,2021-05-30 18:05:53
3092,22,Manipur,451219,380882,70337,2021-05-30 18:05:53
3093,23,Meghalaya,464224,389900,74324,2021-05-30 18:05:53
3094,24,Mizoram,313453,262366,51087,2021-05-30 18:05:53
3095,25,Nagaland,262571,210641,51930,2021-05-30 18:05:53
3096,26,Odisha,7727970,6257322,1470648,2021-05-30 18:05:53
3097,27,Puducherry,265768,214593,51175,2021-05-30 18:05:53
3098,28,Punjab,4602591,3837481,765110,2021-05-30 18:05:53
3099,29,Rajasthan,16865658,13767364,3098294,2021-05-30 18:05:53
3100,30,Sikkim,238891,179238,59653,2021-05-30 18:05:53
3101,31,Tamil Nadu,8893998,6875084,2018914,2021-05-30 18:05:53
3102,32,Telangana,5985460,4737360,1248100,2021-05-30 18:05:53
3103,33,Tripura,1602077,1094499,507578,2021-05-30 18:05:53
3104,34,Uttar Pradesh,18010911,14560582,3450329,2021-05-30 18:05:53
3105,35,Uttarakhand,2901614,2218328,683286,2021-05-30 18:05:53
3106,36,West Bengal,14412969,10547015,3865954,2021-05-30 18:05:53
3107,37,Daman and Diu,101301,87280,14021,2021-05-30 18:05:53
3108,1,Andaman and Nicobar Islands,124268,109087,15181,2021-05-31 18:03:42
3109,2,Andhra Pradesh,9868747,7356423,2512324,2021-05-31 18:03:42
3110,3,Arunachal Pradesh,334007,255678,78329,2021-05-31 18:03:42
3111,4,Assam,4137653,3304493,833160,2021-05-31 18:03:42
3112,5,Bihar,10307600,8516097,1791503,2021-05-31 18:03:42
3113,6,Chandigarh,349507,274606,74901,2021-05-31 18:03:42
3114,7,Chhattisgarh,6240528,5134658,1105870,2021-05-31 18:03:42
3115,8,Dadra and Nagar Haveli,90938,78997,11941,2021-05-31 18:03:42
3116,9,Delhi,5419341,4194986,1224355,2021-05-31 18:03:42
3117,10,Goa,528955,433855,95100,2021-05-31 18:03:42
3118,11,Gujarat,17110619,12965663,4144956,2021-05-31 18:03:42
3119,12,Haryana,5889201,4893257,995944,2021-05-31 18:03:42
3120,13,Himachal Pradesh,2456257,2022636,433621,2021-05-31 18:03:42
3121,14,Jammu and Kashmir,3301002,2754861,546141,2021-05-31 18:03:42
3122,15,Jharkhand,4194352,3484293,710059,2021-05-31 18:03:42
3123,16,Karnataka,13683390,10929687,2753703,2021-05-31 18:03:42
3124,17,Kerala,9413723,7345141,2068582,2021-05-31 18:03:42
3125,18,Ladakh,159496,122206,37290,2021-05-31 18:03:42
3126,19,Lakshadweep,33636,26687,6949,2021-05-31 18:03:42
3127,20,Madhya Pradesh,11170319,9378050,1792269,2021-05-31 18:03:42
3128,21,Maharashtra,22586620,18016877,4569743,2021-05-31 18:03:42
3129,22,Manipur,457938,387493,70445,2021-05-31 18:03:42
3130,23,Meghalaya,465690,391350,74340,2021-05-31 18:03:42
3131,24,Mizoram,315245,264128,51117,2021-05-31 18:03:42
3132,25,Nagaland,268922,216978,51944,2021-05-31 18:03:42
3133,26,Odisha,7857798,6380707,1477091,2021-05-31 18:03:42
3134,27,Puducherry,269328,218077,51251,2021-05-31 18:03:42
3135,28,Punjab,4639262,3868801,770461,2021-05-31 18:03:42
3136,29,Rajasthan,17016331,13900165,3116166,2021-05-31 18:03:42
3137,30,Sikkim,238983,179322,59661,2021-05-31 18:03:42
3138,31,Tamil Nadu,9095854,7063107,2032747,2021-05-31 18:03:42
3139,32,Telangana,6064809,4802730,1262079,2021-05-31 18:03:42
3140,33,Tripura,1610784,1103113,507671,2021-05-31 18:03:42
3141,34,Uttar Pradesh,18335009,14854570,3480439,2021-05-31 18:03:42
3142,35,Uttarakhand,2919103,2235181,683922,2021-05-31 18:03:42
3143,36,West Bengal,14718135,10838457,3879678,2021-05-31 18:03:42
3144,37,Daman and Diu,105141,91108,14033,2021-05-31 18:03:42
3145,1,Andaman and Nicobar Islands,125007,109821,15186,2021-06-01 18:09:03
3146,2,Andhra Pradesh,10083415,7553586,2529829,2021-06-01 18:09:03
3147,3,Arunachal Pradesh,336634,258237,78397,2021-06-01 18:09:03
3148,4,Assam,4174820,3337376,837444,2021-06-01 18:09:03
3149,5,Bihar,10366689,8563603,1803086,2021-06-01 18:09:03
3150,6,Chandigarh,355311,280378,74933,2021-06-01 18:09:03
3151,7,Chhattisgarh,6252505,5139437,1113068,2021-06-01 18:09:03
3152,8,Dadra and Nagar Haveli,93221,81277,11944,2021-06-01 18:09:03
3153,9,Delhi,5469628,4228359,1241269,2021-06-01 18:09:03
3154,10,Goa,533504,438285,95219,2021-06-01 18:09:03
3155,11,Gujarat,17309564,13131370,4178194,2021-06-01 18:09:03
3156,12,Haryana,5956635,4955133,1001502,2021-06-01 18:09:03
3157,13,Himachal Pradesh,2471148,2037384,433764,2021-06-01 18:09:03
3158,14,Jammu and Kashmir,3334213,2784248,549965,2021-06-01 18:09:03
3159,15,Jharkhand,4227513,3512443,715070,2021-06-01 18:09:03
3160,16,Karnataka,13906541,11133566,2772975,2021-06-01 18:09:03
3161,17,Kerala,9583560,7494522,2089038,2021-06-01 18:09:03
3162,18,Ladakh,164155,126864,37291,2021-06-01 18:09:03
3163,19,Lakshadweep,34439,27489,6950,2021-06-01 18:09:03
3164,20,Madhya Pradesh,11188263,9394692,1793571,2021-06-01 18:09:03
3165,21,Maharashtra,22850264,18233839,4616425,2021-06-01 18:09:03
3166,22,Manipur,462332,391812,70520,2021-06-01 18:09:03
3167,23,Meghalaya,467917,393547,74370,2021-06-01 18:09:03
3168,24,Mizoram,316266,265122,51144,2021-06-01 18:09:03
3169,25,Nagaland,274959,223006,51953,2021-06-01 18:09:03
3170,26,Odisha,7962783,6479679,1483104,2021-06-01 18:09:03
3171,27,Puducherry,272660,221333,51327,2021-06-01 18:09:03
3172,28,Punjab,4675210,3899387,775823,2021-06-01 18:09:03
3173,29,Rajasthan,17124031,13990636,3133395,2021-06-01 18:09:03
3174,30,Sikkim,239043,179370,59673,2021-06-01 18:09:03
3175,31,Tamil Nadu,9240004,7190142,2049862,2021-06-01 18:09:03
3176,32,Telangana,6151360,4878994,1272366,2021-06-01 18:09:03
3177,33,Tripura,1615053,1107337,507716,2021-06-01 18:09:03
3178,34,Uttar Pradesh,18685319,15179836,3505483,2021-06-01 18:09:03
3179,35,Uttarakhand,2932620,2248175,684445,2021-06-01 18:09:03
3180,36,West Bengal,14969157,11075394,3893763,2021-06-01 18:09:03
3181,37,Daman and Diu,108779,94733,14046,2021-06-01 18:09:03
3182,1,Andaman and Nicobar Islands,125514,110323,15191,2021-06-02 18:17:18
3183,2,Andhra Pradesh,10243842,7696078,2547764,2021-06-02 18:17:18
3184,3,Arunachal Pradesh,343311,264847,78464,2021-06-02 18:17:18
3185,4,Assam,4200000,3359700,840300,2021-06-02 18:17:18
3186,5,Bihar,10424975,8612656,1812319,2021-06-02 18:17:18
3187,6,Chandigarh,360794,285834,74960,2021-06-02 18:17:18
3188,7,Chhattisgarh,6260124,5143077,1117047,2021-06-02 18:17:18
3189,8,Dadra and Nagar Haveli,95271,83324,11947,2021-06-02 18:17:18
3190,9,Delhi,5506534,4257176,1249358,2021-06-02 18:17:18
3191,10,Goa,537792,442390,95402,2021-06-02 18:17:18
3192,11,Gujarat,17486132,13283712,4202420,2021-06-02 18:17:18
3193,12,Haryana,6029937,5025000,1004937,2021-06-02 18:17:18
3194,13,Himachal Pradesh,2482794,2048963,433831,2021-06-02 18:17:18
3195,14,Jammu and Kashmir,3367582,2813904,553678,2021-06-02 18:17:18
3196,15,Jharkhand,4266420,3545235,721185,2021-06-02 18:17:18
3197,16,Karnataka,14154710,11363561,2791149,2021-06-02 18:17:18
3198,17,Kerala,9689249,7585560,2103689,2021-06-02 18:17:18
3199,18,Ladakh,167934,130639,37295,2021-06-02 18:17:18
3200,19,Lakshadweep,35167,28215,6952,2021-06-02 18:17:18
3201,20,Madhya Pradesh,11481427,9680087,1801340,2021-06-02 18:17:18
3202,21,Maharashtra,23077246,18425383,4651863,2021-06-02 18:17:18
3203,22,Manipur,469900,399272,70628,2021-06-02 18:17:18
3204,23,Meghalaya,469583,395183,74400,2021-06-02 18:17:18
3205,24,Mizoram,316742,265590,51152,2021-06-02 18:17:18
3206,25,Nagaland,277162,225169,51993,2021-06-02 18:17:18
3207,26,Odisha,8035993,6549112,1486881,2021-06-02 18:17:18
3208,27,Puducherry,276052,224650,51402,2021-06-02 18:17:18
3209,28,Punjab,4712161,3932229,779932,2021-06-02 18:17:18
3210,29,Rajasthan,17240714,14090093,3150621,2021-06-02 18:17:18
3211,30,Sikkim,239174,179483,59691,2021-06-02 18:17:18
3212,31,Tamil Nadu,9349171,7286844,2062327,2021-06-02 18:17:18
3213,32,Telangana,6226923,4947737,1279186,2021-06-02 18:17:18
3214,33,Tripura,1618490,1110714,507776,2021-06-02 18:17:18
3215,34,Uttar Pradesh,19045624,15512608,3533016,2021-06-02 18:17:18
3216,35,Uttarakhand,2944942,2259962,684980,2021-06-02 18:17:18
3217,36,West Bengal,15186412,11283299,3903113,2021-06-02 18:17:18
3218,37,Daman and Diu,112399,98341,14058,2021-06-02 18:17:18
3219,1,Andaman and Nicobar Islands,126200,111001,15199,2021-06-03 18:01:37
3220,2,Andhra Pradesh,10341301,7786969,2554332,2021-06-03 18:01:37
3221,3,Arunachal Pradesh,351449,272908,78541,2021-06-03 18:01:37
3222,4,Assam,4235371,3392421,842950,2021-06-03 18:01:37
3223,5,Bihar,10585288,8764409,1820879,2021-06-03 18:01:37
3224,6,Chandigarh,366709,291718,74991,2021-06-03 18:01:37
3225,7,Chhattisgarh,6267748,5146027,1121721,2021-06-03 18:01:37
3226,8,Dadra and Nagar Haveli,97612,85660,11952,2021-06-03 18:01:37
3227,9,Delhi,5559386,4294738,1264648,2021-06-03 18:01:37
3228,10,Goa,543715,448111,95604,2021-06-03 18:01:37
3229,11,Gujarat,17665975,13433285,4232690,2021-06-03 18:01:37
3230,12,Haryana,6104370,5094715,1009655,2021-06-03 18:01:37
3231,13,Himachal Pradesh,2494074,2060164,433910,2021-06-03 18:01:37
3232,14,Jammu and Kashmir,3398622,2841416,557206,2021-06-03 18:01:37
3233,15,Jharkhand,4306358,3580164,726194,2021-06-03 18:01:37
3234,16,Karnataka,14407706,11596660,2811046,2021-06-03 18:01:37
3235,17,Kerala,9850288,7730989,2119299,2021-06-03 18:01:37
3236,18,Ladakh,171395,134095,37300,2021-06-03 18:01:37
3237,19,Lakshadweep,36206,29251,6955,2021-06-03 18:01:37
3238,20,Madhya Pradesh,11853494,10041226,1812268,2021-06-03 18:01:37
3239,21,Maharashtra,23302845,18623132,4679713,2021-06-03 18:01:37
3240,22,Manipur,472549,401838,70711,2021-06-03 18:01:37
3241,23,Meghalaya,471884,397450,74434,2021-06-03 18:01:37
3242,24,Mizoram,318199,267028,51171,2021-06-03 18:01:37
3243,25,Nagaland,279796,227788,52008,2021-06-03 18:01:37
3244,26,Odisha,8110698,6619136,1491562,2021-06-03 18:01:37
3245,27,Puducherry,279327,227847,51480,2021-06-03 18:01:37
3246,28,Punjab,4749239,3965188,784051,2021-06-03 18:01:37
3247,29,Rajasthan,17334159,14169376,3164783,2021-06-03 18:01:37
3248,30,Sikkim,239355,179658,59697,2021-06-03 18:01:37
3249,31,Tamil Nadu,9620641,7545710,2074931,2021-06-03 18:01:37
3250,32,Telangana,6320774,5033655,1287119,2021-06-03 18:01:37
3251,33,Tripura,1624620,1116768,507852,2021-06-03 18:01:37
3252,34,Uttar Pradesh,19436908,15875135,3561773,2021-06-03 18:01:37
3253,35,Uttarakhand,2962710,2277114,685596,2021-06-03 18:01:37
3254,36,West Bengal,15430414,11514760,3915654,2021-06-03 18:01:37
3255,37,Daman and Diu,114186,100124,14062,2021-06-03 18:01:37
3256,1,Andaman and Nicobar Islands,126713,111506,15207,2021-06-04 18:08:05
3257,2,Andhra Pradesh,10708410,8141170,2567240,2021-06-04 18:08:05
3258,3,Arunachal Pradesh,362909,284334,78575,2021-06-04 18:08:05
3259,4,Assam,4274481,3429205,845276,2021-06-04 18:08:05
3260,5,Bihar,10772252,8941673,1830579,2021-06-04 18:08:05
3261,6,Chandigarh,372191,297146,75045,2021-06-04 18:08:05
3262,7,Chhattisgarh,6274404,5148601,1125803,2021-06-04 18:08:05
3263,8,Dadra and Nagar Haveli,100283,88319,11964,2021-06-04 18:08:05
3264,9,Delhi,5599054,4329324,1269730,2021-06-04 18:08:05
3265,10,Goa,551988,456053,95935,2021-06-04 18:08:05
3266,11,Gujarat,17936071,13674583,4261488,2021-06-04 18:08:05
3267,12,Haryana,6166025,5151851,1014174,2021-06-04 18:08:05
3268,13,Himachal Pradesh,2509695,2075616,434079,2021-06-04 18:08:05
3269,14,Jammu and Kashmir,3429944,2868479,561465,2021-06-04 18:08:05
3270,15,Jharkhand,4378641,3646348,732293,2021-06-04 18:08:05
3271,16,Karnataka,14735361,11899361,2836000,2021-06-04 18:08:05
3272,17,Kerala,10026627,7888884,2137743,2021-06-04 18:08:05
3273,18,Ladakh,174899,137598,37301,2021-06-04 18:08:05
3274,19,Lakshadweep,37342,30378,6964,2021-06-04 18:08:05
3275,20,Madhya Pradesh,12217489,10399189,1818300,2021-06-04 18:08:05
3276,21,Maharashtra,23687499,18959397,4728102,2021-06-04 18:08:05
3277,22,Manipur,483199,412409,70790,2021-06-04 18:08:05
3278,23,Meghalaya,474607,400152,74455,2021-06-04 18:08:05
3279,24,Mizoram,322297,271082,51215,2021-06-04 18:08:05
3280,25,Nagaland,281682,229634,52048,2021-06-04 18:08:05
3281,26,Odisha,8201860,6703769,1498091,2021-06-04 18:08:05
3282,27,Puducherry,282192,230627,51565,2021-06-04 18:08:05
3283,28,Punjab,4809245,4020410,788835,2021-06-04 18:08:05
3284,29,Rajasthan,17488910,14298417,3190493,2021-06-04 18:08:05
3285,30,Sikkim,239548,179835,59713,2021-06-04 18:08:05
3286,31,Tamil Nadu,9876220,7790199,2086021,2021-06-04 18:08:05
3287,32,Telangana,6428387,5133125,1295262,2021-06-04 18:08:05
3288,33,Tripura,1631384,1123405,507979,2021-06-04 18:08:05
3289,34,Uttar Pradesh,19850174,16254617,3595557,2021-06-04 18:08:05
3290,35,Uttarakhand,2988289,2301935,686354,2021-06-04 18:08:05
3291,36,West Bengal,15726490,11795260,3931230,2021-06-04 18:08:05
3292,37,Daman and Diu,115519,101446,14073,2021-06-04 18:08:05
3293,1,Andaman and Nicobar Islands,127194,111971,15223,2021-06-05 18:13:07
3294,2,Andhra Pradesh,10803822,8231348,2572474,2021-06-05 18:13:07
3295,3,Arunachal Pradesh,372776,294176,78600,2021-06-05 18:13:07
3296,4,Assam,4315221,3467449,847772,2021-06-05 18:13:07
3297,5,Bihar,10922525,9083469,1839056,2021-06-05 18:13:07
3298,6,Chandigarh,377873,302775,75098,2021-06-05 18:13:07
3299,7,Chhattisgarh,6282084,5151405,1130679,2021-06-05 18:13:07
3300,8,Dadra and Nagar Haveli,103019,91040,11979,2021-06-05 18:13:07
3301,9,Delhi,5656091,4371075,1285016,2021-06-05 18:13:07
3302,10,Goa,563779,467529,96250,2021-06-05 18:13:07
3303,11,Gujarat,18201215,13915183,4286032,2021-06-05 18:13:07
3304,12,Haryana,6224238,5205904,1018334,2021-06-05 18:13:07
3305,13,Himachal Pradesh,2523243,2089053,434190,2021-06-05 18:13:07
3306,14,Jammu and Kashmir,3461430,2896360,565070,2021-06-05 18:13:07
3307,15,Jharkhand,4470721,3732019,738702,2021-06-05 18:13:07
3308,16,Karnataka,15068597,12206183,2862414,2021-06-05 18:13:07
3309,17,Kerala,10214963,8057972,2156991,2021-06-05 18:13:07
3310,18,Ladakh,177678,140366,37312,2021-06-05 18:13:07
3311,19,Lakshadweep,38294,31322,6972,2021-06-05 18:13:07
3312,20,Madhya Pradesh,12629509,10796888,1832621,2021-06-05 18:13:07
3313,21,Maharashtra,24049547,19278027,4771520,2021-06-05 18:13:07
3314,22,Manipur,492404,421488,70916,2021-06-05 18:13:07
3315,23,Meghalaya,476743,402281,74462,2021-06-05 18:13:07
3316,24,Mizoram,323535,272320,51215,2021-06-05 18:13:07
3317,25,Nagaland,281890,229841,52049,2021-06-05 18:13:07
3318,26,Odisha,8283001,6778101,1504900,2021-06-05 18:13:07
3319,27,Puducherry,286551,234886,51665,2021-06-05 18:13:07
3320,28,Punjab,4872289,4079301,792988,2021-06-05 18:13:07
3321,29,Rajasthan,17662091,14444962,3217129,2021-06-05 18:13:07
3322,30,Sikkim,239628,179914,59714,2021-06-05 18:13:07
3323,31,Tamil Nadu,10018873,7924700,2094173,2021-06-05 18:13:07
3324,32,Telangana,6577056,5274798,1302258,2021-06-05 18:13:07
3325,33,Tripura,1635643,1127599,508044,2021-06-05 18:13:07
3326,34,Uttar Pradesh,20252136,16624925,3627211,2021-06-05 18:13:07
3327,35,Uttarakhand,3025671,2338708,686963,2021-06-05 18:13:07
3328,36,West Bengal,16031152,12090072,3941080,2021-06-05 18:13:07
3329,37,Daman and Diu,120021,105938,14083,2021-06-05 18:13:07
3330,1,Andaman and Nicobar Islands,127202,111979,15223,2021-06-06 18:08:51
3331,2,Andhra Pradesh,10869971,8293652,2576319,2021-06-06 18:08:51
3332,3,Arunachal Pradesh,376761,298148,78613,2021-06-06 18:08:51
3333,4,Assam,4339728,3489368,850360,2021-06-06 18:08:51
3334,5,Bihar,11030034,9183267,1846767,2021-06-06 18:08:51
3335,6,Chandigarh,379943,304833,75110,2021-06-06 18:08:51
3336,7,Chhattisgarh,6285625,5152970,1132655,2021-06-06 18:08:51
3337,8,Dadra and Nagar Haveli,103019,91040,11979,2021-06-06 18:08:51
3338,9,Delhi,5671497,4385618,1285879,2021-06-06 18:08:51
3339,10,Goa,570434,474147,96287,2021-06-06 18:08:51
3340,11,Gujarat,18427691,14128072,4299619,2021-06-06 18:08:51
3341,12,Haryana,6246721,5226504,1020217,2021-06-06 18:08:51
3342,13,Himachal Pradesh,2524493,2090289,434204,2021-06-06 18:08:51
3343,14,Jammu and Kashmir,3476138,2910164,565974,2021-06-06 18:08:51
3344,15,Jharkhand,4549765,3806892,742873,2021-06-06 18:08:51
3345,16,Karnataka,15203304,12333182,2870122,2021-06-06 18:08:51
3346,17,Kerala,10270131,8109567,2160564,2021-06-06 18:08:51
3347,18,Ladakh,177681,140369,37312,2021-06-06 18:08:51
3348,19,Lakshadweep,39071,32096,6975,2021-06-06 18:08:51
3349,20,Madhya Pradesh,12759138,10923948,1835190,2021-06-06 18:08:51
3350,21,Maharashtra,24145432,19360252,4785180,2021-06-06 18:08:51
3351,22,Manipur,492511,421595,70916,2021-06-06 18:08:51
3352,23,Meghalaya,476750,402288,74462,2021-06-06 18:08:51
3353,24,Mizoram,323536,272321,51215,2021-06-06 18:08:51
3354,25,Nagaland,282481,230426,52055,2021-06-06 18:08:51
3355,26,Odisha,8296256,6791199,1505057,2021-06-06 18:08:51
3356,27,Puducherry,289091,237400,51691,2021-06-06 18:08:51
3357,28,Punjab,4911988,4117141,794847,2021-06-06 18:08:51
3358,29,Rajasthan,17743175,14513474,3229701,2021-06-06 18:08:51
3359,30,Sikkim,239779,180065,59714,2021-06-06 18:08:51
3360,31,Tamil Nadu,10069493,7972482,2097011,2021-06-06 18:08:51
3361,32,Telangana,6695588,5391957,1303631,2021-06-06 18:08:51
3362,33,Tripura,1636673,1128612,508061,2021-06-06 18:08:51
3363,34,Uttar Pradesh,20272802,16643702,3629100,2021-06-06 18:08:51
3364,35,Uttarakhand,3050222,2362816,687406,2021-06-06 18:08:51
3365,36,West Bengal,16149949,12206706,3943243,2021-06-06 18:08:51
3366,37,Daman and Diu,120505,106417,14088,2021-06-06 18:08:51
3367,1,Andaman and Nicobar Islands,127759,112507,15252,2021-06-07 18:07:23
3368,2,Andhra Pradesh,11013621,8429887,2583734,2021-06-07 18:07:23
3369,3,Arunachal Pradesh,384701,306022,78679,2021-06-07 18:07:23
3370,4,Assam,4389697,3534232,855465,2021-06-07 18:07:23
3371,5,Bihar,11134737,9277636,1857101,2021-06-07 18:07:23
3372,6,Chandigarh,383353,308126,75227,2021-06-07 18:07:23
3373,7,Chhattisgarh,6290982,5155182,1135800,2021-06-07 18:07:23
3374,8,Dadra and Nagar Haveli,105833,93847,11986,2021-06-07 18:07:23
3375,9,Delhi,5737887,4419597,1318290,2021-06-07 18:07:23
3376,10,Goa,581671,485171,96500,2021-06-07 18:07:23
3377,11,Gujarat,18686516,14359541,4326975,2021-06-07 18:07:23
3378,12,Haryana,6302108,5276368,1025740,2021-06-07 18:07:23
3379,13,Himachal Pradesh,2536559,2102102,434457,2021-06-07 18:07:23
3380,14,Jammu and Kashmir,3501829,2932304,569525,2021-06-07 18:07:23
3381,15,Jharkhand,4613214,3864177,749037,2021-06-07 18:07:23
3382,16,Karnataka,15504527,12612607,2891920,2021-06-07 18:07:23
3383,17,Kerala,10473049,8302066,2170983,2021-06-07 18:07:23
3384,18,Ladakh,180269,142943,37326,2021-06-07 18:07:23
3385,19,Lakshadweep,40301,33318,6983,2021-06-07 18:07:23
3386,20,Madhya Pradesh,13151267,11299196,1852071,2021-06-07 18:07:23
3387,21,Maharashtra,24450364,19597498,4852866,2021-06-07 18:07:23
3388,22,Manipur,504594,433599,70995,2021-06-07 18:07:23
3389,23,Meghalaya,478264,403761,74503,2021-06-07 18:07:23
3390,24,Mizoram,327729,276319,51410,2021-06-07 18:07:23
3391,25,Nagaland,291666,239568,52098,2021-06-07 18:07:23
3392,26,Odisha,8462518,6938186,1524332,2021-06-07 18:07:23
3393,27,Puducherry,294440,242580,51860,2021-06-07 18:07:23
3394,28,Punjab,4962200,4163128,799072,2021-06-07 18:07:23
3395,29,Rajasthan,17872011,14615154,3256857,2021-06-07 18:07:23
3396,30,Sikkim,240036,180310,59726,2021-06-07 18:07:23
3397,31,Tamil Nadu,10135731,8031685,2104046,2021-06-07 18:07:23
3398,32,Telangana,6865466,5554284,1311182,2021-06-07 18:07:23
3399,33,Tripura,1640638,1132397,508241,2021-06-07 18:07:23
3400,34,Uttar Pradesh,20735794,17079924,3655870,2021-06-07 18:07:23
3401,35,Uttarakhand,3084855,2396288,688567,2021-06-07 18:07:23
3402,36,West Bengal,16453879,12492937,3960942,2021-06-07 18:07:23
3403,37,Daman and Diu,123423,109324,14099,2021-06-07 18:07:23
3404,1,Andaman and Nicobar Islands,128195,112917,15278,2021-06-08 18:09:01
3405,2,Andhra Pradesh,11059995,8472406,2587589,2021-06-08 18:09:01
3406,3,Arunachal Pradesh,390012,311287,78725,2021-06-08 18:09:01
3407,4,Assam,4451360,3590740,860620,2021-06-08 18:09:01
3408,5,Bihar,11231592,9362801,1868791,2021-06-08 18:09:01
3409,6,Chandigarh,384919,309608,75311,2021-06-08 18:09:01
3410,7,Chhattisgarh,6296915,5157533,1139382,2021-06-08 18:09:01
3411,8,Dadra and Nagar Haveli,108548,96550,11998,2021-06-08 18:09:01
3412,9,Delhi,5786229,4445352,1340877,2021-06-08 18:09:01
3413,10,Goa,592178,495452,96726,2021-06-08 18:09:01
3414,11,Gujarat,18949901,14587473,4362428,2021-06-08 18:09:01
3415,12,Haryana,6350659,5319508,1031151,2021-06-08 18:09:01
3416,13,Himachal Pradesh,2549426,2114649,434777,2021-06-08 18:09:01
3417,14,Jammu and Kashmir,3528456,2955248,573208,2021-06-08 18:09:01
3418,15,Jharkhand,4673692,3918642,755050,2021-06-08 18:09:01
3419,16,Karnataka,15759842,12847608,2912234,2021-06-08 18:09:01
3420,17,Kerala,10692008,8503125,2188883,2021-06-08 18:09:01
3421,18,Ladakh,181714,144376,37338,2021-06-08 18:09:01
3422,19,Lakshadweep,41455,34466,6989,2021-06-08 18:09:01
3423,20,Madhya Pradesh,13217372,11361743,1855629,2021-06-08 18:09:01
3424,21,Maharashtra,24728789,19794750,4934039,2021-06-08 18:09:01
3425,22,Manipur,511639,440535,71104,2021-06-08 18:09:01
3426,23,Meghalaya,479293,404762,74531,2021-06-08 18:09:01
3427,24,Mizoram,331535,279959,51576,2021-06-08 18:09:01
3428,25,Nagaland,301511,249356,52155,2021-06-08 18:09:01
3429,26,Odisha,8613888,7068512,1545376,2021-06-08 18:09:01
3430,27,Puducherry,300252,248250,52002,2021-06-08 18:09:01
3431,28,Punjab,5010368,4207220,803148,2021-06-08 18:09:01
3432,29,Rajasthan,18040679,14759272,3281407,2021-06-08 18:09:01
3433,30,Sikkim,240711,180973,59738,2021-06-08 18:09:01
3434,31,Tamil Nadu,10185541,8076791,2108750,2021-06-08 18:09:01
3435,32,Telangana,7046084,5728537,1317547,2021-06-08 18:09:01
3436,33,Tripura,1644382,1135952,508430,2021-06-08 18:09:01
3437,34,Uttar Pradesh,21181060,17502314,3678746,2021-06-08 18:09:01
3438,35,Uttarakhand,3118649,2429187,689462,2021-06-08 18:09:01
3439,36,West Bengal,16717047,12742698,3974349,2021-06-08 18:09:01
3440,37,Daman and Diu,126722,112574,14148,2021-06-08 18:09:01
3441,1,Andaman and Nicobar Islands,128498,113207,15291,2021-06-09 18:08:30
3442,2,Andhra Pradesh,11234803,8637923,2596880,2021-06-09 18:08:30
3443,3,Arunachal Pradesh,395757,316960,78797,2021-06-09 18:08:30
3444,4,Assam,4491566,3623460,868106,2021-06-09 18:08:30
3445,5,Bihar,11409331,9530621,1878710,2021-06-09 18:08:30
3446,6,Chandigarh,387273,311860,75413,2021-06-09 18:08:30
3447,7,Chhattisgarh,6304358,5160281,1144077,2021-06-09 18:08:30
3448,8,Dadra and Nagar Haveli,110709,98705,12004,2021-06-09 18:08:30
3449,9,Delhi,5834482,4471099,1363383,2021-06-09 18:08:30
3450,10,Goa,600833,503890,96943,2021-06-09 18:08:30
3451,11,Gujarat,19203211,14801548,4401663,2021-06-09 18:08:30
3452,12,Haryana,6433899,5398348,1035551,2021-06-09 18:08:30
3453,13,Himachal Pradesh,2557978,2123031,434947,2021-06-09 18:08:30
3454,14,Jammu and Kashmir,3549785,2974987,574798,2021-06-09 18:08:30
3455,15,Jharkhand,4732666,3971153,761513,2021-06-09 18:08:30
3456,16,Karnataka,15992599,13058077,2934522,2021-06-09 18:08:30
3457,17,Kerala,10832105,8634128,2197977,2021-06-09 18:08:30
3458,18,Ladakh,183376,146030,37346,2021-06-09 18:08:30
3459,19,Lakshadweep,42665,35632,7033,2021-06-09 18:08:30
3460,20,Madhya Pradesh,13584232,11708227,1876005,2021-06-09 18:08:30
3461,21,Maharashtra,25042464,20032402,5010062,2021-06-09 18:08:30
3462,22,Manipur,522579,451370,71209,2021-06-09 18:08:30
3463,23,Meghalaya,480229,405629,74600,2021-06-09 18:08:30
3464,24,Mizoram,335091,283221,51870,2021-06-09 18:08:30
3465,25,Nagaland,312189,260001,52188,2021-06-09 18:08:30
3466,26,Odisha,8749836,7183142,1566694,2021-06-09 18:08:30
3467,27,Puducherry,305651,253425,52226,2021-06-09 18:08:30
3468,28,Punjab,5041984,4236020,805964,2021-06-09 18:08:30
3469,29,Rajasthan,18484841,15186893,3297948,2021-06-09 18:08:30
3470,30,Sikkim,244354,184590,59764,2021-06-09 18:08:30
3471,31,Tamil Nadu,10228792,8116108,2112684,2021-06-09 18:08:30
3472,32,Telangana,7224148,5900344,1323804,2021-06-09 18:08:30
3473,33,Tripura,1646329,1137795,508534,2021-06-09 18:08:30
3474,34,Uttar Pradesh,21584490,17883157,3701333,2021-06-09 18:08:30
3475,35,Uttarakhand,3156637,2466183,690454,2021-06-09 18:08:30
3476,36,West Bengal,16940919,12954543,3986376,2021-06-09 18:08:30
3477,37,Daman and Diu,129470,115309,14161,2021-06-09 18:08:30
3478,1,Andaman and Nicobar Islands,129402,114098,15304,2021-06-10 18:08:35
3479,2,Andhra Pradesh,11496440,8891341,2605099,2021-06-10 18:08:35
3480,3,Arunachal Pradesh,400648,321736,78912,2021-06-10 18:08:35
3481,4,Assam,4585754,3695526,890228,2021-06-10 18:08:35
3482,5,Bihar,11599819,9712352,1887467,2021-06-10 18:08:35
3483,6,Chandigarh,389571,314057,75514,2021-06-10 18:08:35
3484,7,Chhattisgarh,6311317,5162838,1148479,2021-06-10 18:08:35
3485,8,Dadra and Nagar Haveli,113105,101093,12012,2021-06-10 18:08:35
3486,9,Delhi,5916278,4521905,1394373,2021-06-10 18:08:35
3487,10,Goa,608564,511379,97185,2021-06-10 18:08:35
3488,11,Gujarat,19478852,15022634,4456218,2021-06-10 18:08:35
3489,12,Haryana,6559087,5514458,1044629,2021-06-10 18:08:35
3490,13,Himachal Pradesh,2566399,2131119,435280,2021-06-10 18:08:35
3491,14,Jammu and Kashmir,3582621,3005115,577506,2021-06-10 18:08:35
3492,15,Jharkhand,4802571,4036613,765958,2021-06-10 18:08:35
3493,16,Karnataka,16249047,13294675,2954372,2021-06-10 18:08:35
3494,17,Kerala,10983039,8772285,2210754,2021-06-10 18:08:35
3495,18,Ladakh,185674,148313,37361,2021-06-10 18:08:35
3496,19,Lakshadweep,43565,36523,7042,2021-06-10 18:08:35
3497,20,Madhya Pradesh,13769115,11877371,1891744,2021-06-10 18:08:35
3498,21,Maharashtra,25300779,20232933,5067846,2021-06-10 18:08:35
3499,22,Manipur,527496,456202,71294,2021-06-10 18:08:35
3500,23,Meghalaya,482623,407975,74648,2021-06-10 18:08:35
3501,24,Mizoram,339631,287744,51887,2021-06-10 18:08:35
3502,25,Nagaland,320312,268004,52308,2021-06-10 18:08:35
3503,26,Odisha,8806405,7225627,1580778,2021-06-10 18:08:35
3504,27,Puducherry,311816,259372,52444,2021-06-10 18:08:35
3505,28,Punjab,5070549,4261364,809185,2021-06-10 18:08:35
3506,29,Rajasthan,18832537,15524081,3308456,2021-06-10 18:08:35
3507,30,Sikkim,252346,192568,59778,2021-06-10 18:08:35
3508,31,Tamil Nadu,10272414,8156189,2116225,2021-06-10 18:08:35
3509,32,Telangana,7404779,6074863,1329916,2021-06-10 18:08:35
3510,33,Tripura,1649999,1141134,508865,2021-06-10 18:08:35
3511,34,Uttar Pradesh,22025903,18297125,3728778,2021-06-10 18:08:35
3512,35,Uttarakhand,3207393,2515957,691436,2021-06-10 18:08:35
3513,36,West Bengal,17139018,13143096,3995922,2021-06-10 18:08:35
3514,37,Daman and Diu,131995,117811,14184,2021-06-10 18:08:35
3515,1,Andaman and Nicobar Islands,130173,114850,15323,2021-06-11 18:09:06
3516,2,Andhra Pradesh,11696369,9085932,2610437,2021-06-11 18:09:06
3517,3,Arunachal Pradesh,405483,326492,78991,2021-06-11 18:09:06
3518,4,Assam,4674511,3769894,904617,2021-06-11 18:09:06
3519,5,Bihar,11778969,9881658,1897311,2021-06-11 18:09:06
3520,6,Chandigarh,395515,319892,75623,2021-06-11 18:09:06
3521,7,Chhattisgarh,6318147,5165344,1152803,2021-06-11 18:09:06
3522,8,Dadra and Nagar Haveli,117232,105199,12033,2021-06-11 18:09:06
3523,9,Delhi,5995748,4583464,1412284,2021-06-11 18:09:06
3524,10,Goa,614418,516897,97521,2021-06-11 18:09:06
3525,11,Gujarat,19769106,15262470,4506636,2021-06-11 18:09:06
3526,12,Haryana,6664080,5608575,1055505,2021-06-11 18:09:06
3527,13,Himachal Pradesh,2576674,2141030,435644,2021-06-11 18:09:06
3528,14,Jammu and Kashmir,3616809,3036734,580075,2021-06-11 18:09:06
3529,15,Jharkhand,4896908,4123823,773085,2021-06-11 18:09:06
3530,16,Karnataka,16580369,13599544,2980825,2021-06-11 18:09:06
3531,17,Kerala,11102819,8879020,2223799,2021-06-11 18:09:06
3532,18,Ladakh,189143,151780,37363,2021-06-11 18:09:06
3533,19,Lakshadweep,44754,37701,7053,2021-06-11 18:09:06
3534,20,Madhya Pradesh,13796834,11899138,1897696,2021-06-11 18:09:06
3535,21,Maharashtra,25560781,20443246,5117535,2021-06-11 18:09:06
3536,22,Manipur,535179,463768,71411,2021-06-11 18:09:06
3537,23,Meghalaya,492296,417634,74662,2021-06-11 18:09:06
3538,24,Mizoram,342961,290926,52035,2021-06-11 18:09:06
3539,25,Nagaland,329360,277015,52345,2021-06-11 18:09:06
3540,26,Odisha,8905797,7298756,1607041,2021-06-11 18:09:06
3541,27,Puducherry,317562,264921,52641,2021-06-11 18:09:06
3542,28,Punjab,5123208,4309836,813372,2021-06-11 18:09:06
3543,29,Rajasthan,19292726,15970989,3321737,2021-06-11 18:09:06
3544,30,Sikkim,264968,205177,59791,2021-06-11 18:09:06
3545,31,Tamil Nadu,10340158,8215741,2124417,2021-06-11 18:09:06
3546,32,Telangana,7616140,6279779,1336361,2021-06-11 18:09:06
3547,33,Tripura,1652388,1143222,509166,2021-06-11 18:09:06
3548,34,Uttar Pradesh,22504047,18741039,3763008,2021-06-11 18:09:06
3549,35,Uttarakhand,3250658,2558034,692624,2021-06-11 18:09:06
3550,36,West Bengal,17382133,13364800,4017333,2021-06-11 18:09:06
3551,37,Daman and Diu,137532,123274,14258,2021-06-11 18:09:06
3552,1,Andaman and Nicobar Islands,131060,115708,15352,2021-06-12 18:08:39
3553,2,Andhra Pradesh,11877129,9257127,2620002,2021-06-12 18:08:39
3554,3,Arunachal Pradesh,410393,331364,79029,2021-06-12 18:08:39
3555,4,Assam,4758849,3841521,917328,2021-06-12 18:08:39
3556,5,Bihar,11938798,10032415,1906383,2021-06-12 18:08:39
3557,6,Chandigarh,401380,325649,75731,2021-06-12 18:08:39
3558,7,Chhattisgarh,6325547,5168451,1157096,2021-06-12 18:08:39
3559,8,Dadra and Nagar Haveli,122042,109995,12047,2021-06-12 18:08:39
3560,9,Delhi,6079589,4638935,1440654,2021-06-12 18:08:39
3561,10,Goa,621644,523796,97848,2021-06-12 18:08:39
3562,11,Gujarat,20068185,15522137,4546048,2021-06-12 18:08:39
3563,12,Haryana,6749944,5686944,1063000,2021-06-12 18:08:39
3564,13,Himachal Pradesh,2587927,2151953,435974,2021-06-12 18:08:39
3565,14,Jammu and Kashmir,3651569,3068862,582707,2021-06-12 18:08:39
3566,15,Jharkhand,4998435,4212899,785536,2021-06-12 18:08:39
3567,16,Karnataka,16892231,13885050,3007181,2021-06-12 18:08:39
3568,17,Kerala,11181355,8943648,2237707,2021-06-12 18:08:39
3569,18,Ladakh,191063,153682,37381,2021-06-12 18:08:39
3570,19,Lakshadweep,46083,39006,7077,2021-06-12 18:08:39
3571,20,Madhya Pradesh,13897841,11956103,1941738,2021-06-12 18:08:39
3572,21,Maharashtra,25866677,20693716,5172961,2021-06-12 18:08:39
3573,22,Manipur,537537,466105,71432,2021-06-12 18:08:39
3574,23,Meghalaya,501614,426926,74688,2021-06-12 18:08:39
3575,24,Mizoram,344187,291868,52319,2021-06-12 18:08:39
3576,25,Nagaland,332870,280522,52348,2021-06-12 18:08:39
3577,26,Odisha,8977717,7347971,1629746,2021-06-12 18:08:39
3578,27,Puducherry,324744,271888,52856,2021-06-12 18:08:39
3579,28,Punjab,5187108,4370081,817027,2021-06-12 18:08:39
3580,29,Rajasthan,19606991,16273082,3333909,2021-06-12 18:08:39
3581,30,Sikkim,273389,213590,59799,2021-06-12 18:08:39
3582,31,Tamil Nadu,10648430,8503345,2145085,2021-06-12 18:08:39
3583,32,Telangana,7830864,6488020,1342844,2021-06-12 18:08:39
3584,33,Tripura,1659919,1147382,512537,2021-06-12 18:08:39
3585,34,Uttar Pradesh,22979323,19184501,3794822,2021-06-12 18:08:39
3586,35,Uttarakhand,3285612,2590812,694800,2021-06-12 18:08:39
3587,36,West Bengal,17600439,13561818,4038621,2021-06-12 18:08:39
3588,37,Daman and Diu,144609,130311,14298,2021-06-12 18:08:39
3589,1,Andaman and Nicobar Islands,131063,115711,15352,2021-06-13 18:07:27
3590,2,Andhra Pradesh,11958631,9335665,2622966,2021-06-13 18:07:27
3591,3,Arunachal Pradesh,414648,335606,79042,2021-06-13 18:07:27
3592,4,Assam,4811949,3883727,928222,2021-06-13 18:07:27
3593,5,Bihar,12032029,10119417,1912612,2021-06-13 18:07:27
3594,6,Chandigarh,405319,329564,75755,2021-06-13 18:07:27
3595,7,Chhattisgarh,6330309,5170438,1159871,2021-06-13 18:07:27
3596,8,Dadra and Nagar Haveli,122112,110065,12047,2021-06-13 18:07:27
3597,9,Delhi,6094030,4650867,1443163,2021-06-13 18:07:27
3598,10,Goa,638918,541029,97889,2021-06-13 18:07:27
3599,11,Gujarat,20303072,15729860,4573212,2021-06-13 18:07:27
3600,12,Haryana,6784770,5718756,1066014,2021-06-13 18:07:27
3601,13,Himachal Pradesh,2588086,2152111,435975,2021-06-13 18:07:27
3602,14,Jammu and Kashmir,3680941,3097492,583449,2021-06-13 18:07:27
3603,15,Jharkhand,5107681,4309176,798505,2021-06-13 18:07:27
3604,16,Karnataka,16998892,13985016,3013876,2021-06-13 18:07:27
3605,17,Kerala,11229829,8989689,2240140,2021-06-13 18:07:27
3606,18,Ladakh,191066,153685,37381,2021-06-13 18:07:27
3607,19,Lakshadweep,46809,39722,7087,2021-06-13 18:07:27
3608,20,Madhya Pradesh,13943751,11992799,1950952,2021-06-13 18:07:27
3609,21,Maharashtra,25958370,20775032,5183338,2021-06-13 18:07:27
3610,22,Manipur,538075,466634,71441,2021-06-13 18:07:27
3611,23,Meghalaya,503182,428483,74699,2021-06-13 18:07:27
3612,24,Mizoram,344187,291868,52319,2021-06-13 18:07:27
3613,25,Nagaland,336121,283761,52360,2021-06-13 18:07:27
3614,26,Odisha,8987379,7356287,1631092,2021-06-13 18:07:27
3615,27,Puducherry,327232,274317,52915,2021-06-13 18:07:27
3616,28,Punjab,5219611,4400382,819229,2021-06-13 18:07:27
3617,29,Rajasthan,19721553,16383144,3338409,2021-06-13 18:07:27
3618,30,Sikkim,273567,213768,59799,2021-06-13 18:07:27
3619,31,Tamil Nadu,10866186,8711904,2154282,2021-06-13 18:07:27
3620,32,Telangana,7981120,6636883,1344237,2021-06-13 18:07:27
3621,33,Tripura,1661096,1148442,512654,2021-06-13 18:07:27
3622,34,Uttar Pradesh,23001682,19205507,3796175,2021-06-13 18:07:27
3623,35,Uttarakhand,3320539,2622029,698510,2021-06-13 18:07:27
3624,36,West Bengal,17657700,13615740,4041960,2021-06-13 18:07:27
3625,37,Daman and Diu,144857,130555,14302,2021-06-13 18:07:27
3626,1,Andaman and Nicobar Islands,132004,116632,15372,2021-06-14 18:08:29
3627,2,Andhra Pradesh,12319387,9683451,2635936,2021-06-14 18:08:29
3628,3,Arunachal Pradesh,420935,341823,79112,2021-06-14 18:08:29
3629,4,Assam,4891540,3937220,954320,2021-06-14 18:08:29
3630,5,Bihar,12133333,10210633,1922700,2021-06-14 18:08:29
3631,6,Chandigarh,412175,336282,75893,2021-06-14 18:08:29
3632,7,Chhattisgarh,6337979,5173815,1164164,2021-06-14 18:08:29
3633,8,Dadra and Nagar Haveli,126748,114675,12073,2021-06-14 18:08:29
3634,9,Delhi,6154661,4690576,1464085,2021-06-14 18:08:29
3635,10,Goa,658193,559670,98523,2021-06-14 18:08:29
3636,11,Gujarat,20587151,15979244,4607907,2021-06-14 18:08:29
3637,12,Haryana,6875456,5797875,1077581,2021-06-14 18:08:29
3638,13,Himachal Pradesh,2614787,2178801,435986,2021-06-14 18:08:29
3639,14,Jammu and Kashmir,3732404,3146640,585764,2021-06-14 18:08:29
3640,15,Jharkhand,5200591,4385314,815277,2021-06-14 18:08:29
3641,16,Karnataka,17262828,14219979,3042849,2021-06-14 18:08:29
3642,17,Kerala,11422135,9154064,2268071,2021-06-14 18:08:29
3643,18,Ladakh,192431,155038,37393,2021-06-14 18:08:29
3644,19,Lakshadweep,47816,40722,7094,2021-06-14 18:08:29
3645,20,Madhya Pradesh,14443636,12452440,1991196,2021-06-14 18:08:29
3646,21,Maharashtra,26263095,21027493,5235602,2021-06-14 18:08:29
3647,22,Manipur,543694,472128,71566,2021-06-14 18:08:29
3648,23,Meghalaya,516828,442099,74729,2021-06-14 18:08:29
3649,24,Mizoram,357314,304964,52350,2021-06-14 18:08:29
3650,25,Nagaland,349528,297104,52424,2021-06-14 18:08:29
3651,26,Odisha,9061121,7407091,1654030,2021-06-14 18:08:29
3652,27,Puducherry,334027,280850,53177,2021-06-14 18:08:29
3653,28,Punjab,5246782,4424663,822119,2021-06-14 18:08:29
3654,29,Rajasthan,19895554,16548285,3347269,2021-06-14 18:08:29
3655,30,Sikkim,286462,226626,59836,2021-06-14 18:08:29
3656,31,Tamil Nadu,11147886,8976866,2171020,2021-06-14 18:08:29
3657,32,Telangana,8167470,6817886,1349584,2021-06-14 18:08:29
3658,33,Tripura,1681689,1164688,517001,2021-06-14 18:08:29
3659,34,Uttar Pradesh,23445493,19608395,3837098,2021-06-14 18:08:29
3660,35,Uttarakhand,3377012,2671224,705788,2021-06-14 18:08:29
3661,36,West Bengal,17867444,13798076,4069368,2021-06-14 18:08:29
3662,37,Daman and Diu,145451,131109,14342,2021-06-14 18:08:29
3663,1,Andaman and Nicobar Islands,132939,117545,15394,2021-06-15 18:01:45
3664,2,Andhra Pradesh,12406367,9765707,2640660,2021-06-15 18:01:45
3665,3,Arunachal Pradesh,426293,347059,79234,2021-06-15 18:01:45
3666,4,Assam,4951863,3984232,967631,2021-06-15 18:01:45
3667,5,Bihar,12205407,10273357,1932050,2021-06-15 18:01:45
3668,6,Chandigarh,419164,343058,76106,2021-06-15 18:01:45
3669,7,Chhattisgarh,6344469,5176603,1167866,2021-06-15 18:01:45
3670,8,Dadra and Nagar Haveli,130771,118673,12098,2021-06-15 18:01:45
3671,9,Delhi,6208289,4719321,1488968,2021-06-15 18:01:45
3672,10,Goa,676789,577925,98864,2021-06-15 18:01:45
3673,11,Gujarat,20855692,16214004,4641688,2021-06-15 18:01:45
3674,12,Haryana,6952038,5862113,1089925,2021-06-15 18:01:45
3675,13,Himachal Pradesh,2659045,2222751,436294,2021-06-15 18:01:45
3676,14,Jammu and Kashmir,3782472,3194499,587973,2021-06-15 18:01:45
3677,15,Jharkhand,5275846,4445031,830815,2021-06-15 18:01:45
3678,16,Karnataka,17482779,14412058,3070721,2021-06-15 18:01:45
3679,17,Kerala,11635416,9307169,2328247,2021-06-15 18:01:45
3680,18,Ladakh,193330,155927,37403,2021-06-15 18:01:45
3681,19,Lakshadweep,48599,41486,7113,2021-06-15 18:01:45
3682,20,Madhya Pradesh,14495499,12497943,1997556,2021-06-15 18:01:45
3683,21,Maharashtra,26524389,21239855,5284534,2021-06-15 18:01:45
3684,22,Manipur,548282,476657,71625,2021-06-15 18:01:45
3685,23,Meghalaya,530738,455958,74780,2021-06-15 18:01:45
3686,24,Mizoram,373131,320738,52393,2021-06-15 18:01:45
3687,25,Nagaland,361734,309229,52505,2021-06-15 18:01:45
3688,26,Odisha,9186151,7503538,1682613,2021-06-15 18:01:45
3689,27,Puducherry,339695,286199,53496,2021-06-15 18:01:45
3690,28,Punjab,5277700,4450734,826966,2021-06-15 18:01:45
3691,29,Rajasthan,19990335,16636379,3353956,2021-06-15 18:01:45
3692,30,Sikkim,302373,242535,59838,2021-06-15 18:01:45
3693,31,Tamil Nadu,11285738,9104491,2181247,2021-06-15 18:01:45
3694,32,Telangana,8333524,6979076,1354448,2021-06-15 18:01:45
3695,33,Tripura,1706142,1185855,520287,2021-06-15 18:01:45
3696,34,Uttar Pradesh,23871523,19995723,3875800,2021-06-15 18:01:45
3697,35,Uttarakhand,3419105,2705277,713828,2021-06-15 18:01:45
3698,36,West Bengal,18123718,14013951,4109767,2021-06-15 18:01:45
3699,37,Daman and Diu,148183,133783,14400,2021-06-15 18:01:45
3700,1,Andaman and Nicobar Islands,133931,118511,15420,2021-06-16 18:14:32
3701,2,Andhra Pradesh,12439899,9795862,2644037,2021-06-16 18:14:32
3702,3,Arunachal Pradesh,438804,359462,79342,2021-06-16 18:14:32
3703,4,Assam,4998717,4018537,980180,2021-06-16 18:14:32
3704,5,Bihar,12716811,10763130,1953681,2021-06-16 18:14:32
3705,6,Chandigarh,425495,349204,76291,2021-06-16 18:14:32
3706,7,Chhattisgarh,6350848,5179502,1171346,2021-06-16 18:14:32
3707,8,Dadra and Nagar Haveli,134116,121993,12123,2021-06-16 18:14:32
3708,9,Delhi,6263721,4756248,1507473,2021-06-16 18:14:32
3709,10,Goa,691969,592719,99250,2021-06-16 18:14:32
3710,11,Gujarat,21112010,16440786,4671224,2021-06-16 18:14:32
3711,12,Haryana,7020156,5919214,1100942,2021-06-16 18:14:32
3712,13,Himachal Pradesh,2699523,2262895,436628,2021-06-16 18:14:32
3713,14,Jammu and Kashmir,3818944,3229615,589329,2021-06-16 18:14:32
3714,15,Jharkhand,5351699,4506462,845237,2021-06-16 18:14:32
3715,16,Karnataka,17695431,14594061,3101370,2021-06-16 18:14:32
3716,17,Kerala,11746936,9386066,2360870,2021-06-16 18:14:32
3717,18,Ladakh,194501,157081,37420,2021-06-16 18:14:32
3718,19,Lakshadweep,49904,42783,7121,2021-06-16 18:14:32
3719,20,Madhya Pradesh,14840484,12815277,2025207,2021-06-16 18:14:32
3720,21,Maharashtra,26774547,21442311,5332236,2021-06-16 18:14:32
3721,22,Manipur,554243,482536,71707,2021-06-16 18:14:32
3722,23,Meghalaya,544781,469951,74830,2021-06-16 18:14:32
3723,24,Mizoram,393779,341373,52406,2021-06-16 18:14:32
3724,25,Nagaland,373071,320460,52611,2021-06-16 18:14:32
3725,26,Odisha,9350452,7631412,1719040,2021-06-16 18:14:32
3726,27,Puducherry,353121,299122,53999,2021-06-16 18:14:32
3727,28,Punjab,5299801,4468606,831195,2021-06-16 18:14:32
3728,29,Rajasthan,20042703,16682442,3360261,2021-06-16 18:14:32
3729,30,Sikkim,317335,257485,59850,2021-06-16 18:14:32
3730,31,Tamil Nadu,11643851,9441618,2202233,2021-06-16 18:14:32
3731,32,Telangana,8511947,7151956,1359991,2021-06-16 18:14:32
3732,33,Tripura,1736324,1213866,522458,2021-06-16 18:14:32
3733,34,Uttar Pradesh,24254164,20343637,3910527,2021-06-16 18:14:32
3734,35,Uttarakhand,3444654,2725505,719149,2021-06-16 18:14:32
3735,36,West Bengal,18249050,14127403,4121647,2021-06-16 18:14:32
3736,37,Daman and Diu,150746,136261,14485,2021-06-16 18:14:32
3737,1,Andaman and Nicobar Islands,134897,119448,15449,2021-06-17 18:02:21
3738,2,Andhra Pradesh,12462701,9817124,2645577,2021-06-17 18:02:21
3739,3,Arunachal Pradesh,453458,374023,79435,2021-06-17 18:02:21
3740,4,Assam,5092307,4089782,1002525,2021-06-17 18:02:21
3741,5,Bihar,12982413,10995411,1987002,2021-06-17 18:02:21
3742,6,Chandigarh,432584,356082,76502,2021-06-17 18:02:21
3743,7,Chhattisgarh,6357584,5182271,1175313,2021-06-17 18:02:21
3744,8,Dadra and Nagar Haveli,137754,125600,12154,2021-06-17 18:02:21
3745,9,Delhi,6355530,4818228,1537302,2021-06-17 18:02:21
3746,10,Goa,708794,609077,99717,2021-06-17 18:02:21
3747,11,Gujarat,21334287,16632294,4701993,2021-06-17 18:02:21
3748,12,Haryana,7150855,6031899,1118956,2021-06-17 18:02:21
3749,13,Himachal Pradesh,2741702,2304599,437103,2021-06-17 18:02:21
3750,14,Jammu and Kashmir,3860287,3267877,592410,2021-06-17 18:02:21
3751,15,Jharkhand,5439159,4580622,858537,2021-06-17 18:02:21
3752,16,Karnataka,17899357,14771770,3127587,2021-06-17 18:02:21
3753,17,Kerala,11895426,9504983,2390443,2021-06-17 18:02:21
3754,18,Ladakh,196717,159275,37442,2021-06-17 18:02:21
3755,19,Lakshadweep,50334,43210,7124,2021-06-17 18:02:21
3756,20,Madhya Pradesh,14975268,12934175,2041093,2021-06-17 18:02:21
3757,21,Maharashtra,26985938,21609227,5376711,2021-06-17 18:02:21
3758,22,Manipur,556448,484633,71815,2021-06-17 18:02:21
3759,23,Meghalaya,562928,487996,74932,2021-06-17 18:02:21
3760,24,Mizoram,410513,357878,52635,2021-06-17 18:02:21
3761,25,Nagaland,382540,329664,52876,2021-06-17 18:02:21
3762,26,Odisha,9506300,7756546,1749754,2021-06-17 18:02:21
3763,27,Puducherry,368948,314298,54650,2021-06-17 18:02:21
3764,28,Punjab,5327778,4490513,837265,2021-06-17 18:02:21
3765,29,Rajasthan,20286459,16920784,3365675,2021-06-17 18:02:21
3766,30,Sikkim,331827,271946,59881,2021-06-17 18:02:21
3767,31,Tamil Nadu,11935112,9713059,2222053,2021-06-17 18:02:21
3768,32,Telangana,8694842,7327371,1367471,2021-06-17 18:02:21
3769,33,Tripura,1791260,1264502,526758,2021-06-17 18:02:21
3770,34,Uttar Pradesh,24673597,20725526,3948071,2021-06-17 18:02:21
3771,35,Uttarakhand,3477183,2752271,724912,2021-06-17 18:02:21
3772,36,West Bengal,18431037,14282047,4148990,2021-06-17 18:02:21
3773,37,Daman and Diu,153121,138597,14524,2021-06-17 18:02:21
3774,1,Andaman and Nicobar Islands,135850,120382,15468,2021-06-18 18:07:43
3775,2,Andhra Pradesh,12487466,9838546,2648920,2021-06-18 18:07:43
3776,3,Arunachal Pradesh,468875,389369,79506,2021-06-18 18:07:43
3777,4,Assam,5210614,4179861,1030753,2021-06-18 18:07:43
3778,5,Bihar,13174680,11158741,2015939,2021-06-18 18:07:43
3779,6,Chandigarh,440585,363813,76772,2021-06-18 18:07:43
3780,7,Chhattisgarh,6365119,5185507,1179612,2021-06-18 18:07:43
3781,8,Dadra and Nagar Haveli,141387,129198,12189,2021-06-18 18:07:43
3782,9,Delhi,6434195,4881510,1552685,2021-06-18 18:07:43
3783,10,Goa,726686,626378,100308,2021-06-18 18:07:43
3784,11,Gujarat,21596263,16854511,4741752,2021-06-18 18:07:43
3785,12,Haryana,7247474,6113489,1133985,2021-06-18 18:07:43
3786,13,Himachal Pradesh,2793097,2354749,438348,2021-06-18 18:07:43
3787,14,Jammu and Kashmir,3910835,3313601,597234,2021-06-18 18:07:43
3788,15,Jharkhand,5546776,4670691,876085,2021-06-18 18:07:43
3789,16,Karnataka,18130798,14971193,3159605,2021-06-18 18:07:43
3790,17,Kerala,11996311,9589345,2406966,2021-06-18 18:07:43
3791,18,Ladakh,198155,160703,37452,2021-06-18 18:07:43
3792,19,Lakshadweep,50773,43642,7131,2021-06-18 18:07:43
3793,20,Madhya Pradesh,14994833,12950585,2044248,2021-06-18 18:07:43
3794,21,Maharashtra,27220156,21802528,5417628,2021-06-18 18:07:43
3795,22,Manipur,561047,489047,72000,2021-06-18 18:07:43
3796,23,Meghalaya,578098,503100,74998,2021-06-18 18:07:43
3797,24,Mizoram,421435,368782,52653,2021-06-18 18:07:43
3798,25,Nagaland,392226,339208,53018,2021-06-18 18:07:43
3799,26,Odisha,9656101,7882328,1773773,2021-06-18 18:07:43
3800,27,Puducherry,385272,330113,55159,2021-06-18 18:07:43
3801,28,Punjab,5356568,4513149,843419,2021-06-18 18:07:43
3802,29,Rajasthan,20630839,17259146,3371693,2021-06-18 18:07:43
3803,30,Sikkim,347391,287492,59899,2021-06-18 18:07:43
3804,31,Tamil Nadu,12148674,9911018,2237656,2021-06-18 18:07:43
3805,32,Telangana,8874911,7499623,1375288,2021-06-18 18:07:43
3806,33,Tripura,1860877,1328982,531895,2021-06-18 18:07:43
3807,34,Uttar Pradesh,25149677,21162728,3986949,2021-06-18 18:07:43
3808,35,Uttarakhand,3515649,2786799,728850,2021-06-18 18:07:43
3809,36,West Bengal,18645621,14455315,4190306,2021-06-18 18:07:43
3810,37,Daman and Diu,156257,141691,14566,2021-06-18 18:07:43
3811,1,Andaman and Nicobar Islands,136707,121201,15506,2021-06-19 18:11:27
3812,2,Andhra Pradesh,12503233,9850955,2652278,2021-06-19 18:11:27
3813,3,Arunachal Pradesh,478167,398545,79622,2021-06-19 18:11:27
3814,4,Assam,5324600,4269193,1055407,2021-06-19 18:11:27
3815,5,Bihar,13509656,11471642,2038014,2021-06-19 18:11:27
3816,6,Chandigarh,450057,372899,77158,2021-06-19 18:11:27
3817,7,Chhattisgarh,6375229,5189635,1185594,2021-06-19 18:11:27
3818,8,Dadra and Nagar Haveli,146467,134208,12259,2021-06-19 18:11:27
3819,9,Delhi,6522118,4943731,1578387,2021-06-19 18:11:27
3820,10,Goa,747361,646436,100925,2021-06-19 18:11:27
3821,11,Gujarat,21903561,17116300,4787261,2021-06-19 18:11:27
3822,12,Haryana,7327041,6180911,1146130,2021-06-19 18:11:27
3823,13,Himachal Pradesh,2819145,2378841,440304,2021-06-19 18:11:27
3824,14,Jammu and Kashmir,3953717,3351691,602026,2021-06-19 18:11:27
3825,15,Jharkhand,5656138,4762333,893805,2021-06-19 18:11:27
3826,16,Karnataka,18421390,15205385,3216005,2021-06-19 18:11:27
3827,17,Kerala,12103202,9676904,2426298,2021-06-19 18:11:27
3828,18,Ladakh,199286,161809,37477,2021-06-19 18:11:27
3829,19,Lakshadweep,51284,44126,7158,2021-06-19 18:11:27
3830,20,Madhya Pradesh,15018743,12964134,2054609,2021-06-19 18:11:27
3831,21,Maharashtra,27616708,22134489,5482219,2021-06-19 18:11:27
3832,22,Manipur,565195,493052,72143,2021-06-19 18:11:27
3833,23,Meghalaya,589906,514835,75071,2021-06-19 18:11:27
3834,24,Mizoram,428686,376032,52654,2021-06-19 18:11:27
3835,25,Nagaland,395022,341974,53048,2021-06-19 18:11:27
3836,26,Odisha,9825907,8019234,1806673,2021-06-19 18:11:27
3837,27,Puducherry,410129,354186,55943,2021-06-19 18:11:27
3838,28,Punjab,5385524,4535431,850093,2021-06-19 18:11:27
3839,29,Rajasthan,20869269,17479778,3389491,2021-06-19 18:11:27
3840,30,Sikkim,358633,298722,59911,2021-06-19 18:11:27
3841,31,Tamil Nadu,12498914,10238404,2260510,2021-06-19 18:11:27
3842,32,Telangana,9069710,7684311,1385399,2021-06-19 18:11:27
3843,33,Tripura,1920866,1383797,537069,2021-06-19 18:11:27
3844,34,Uttar Pradesh,25610808,21587631,4023177,2021-06-19 18:11:27
3845,35,Uttarakhand,3541936,2809750,732186,2021-06-19 18:11:27
3846,36,West Bengal,18937419,14677149,4260270,2021-06-19 18:11:27
3847,37,Daman and Diu,161908,147243,14665,2021-06-19 18:11:27
3848,1,Andaman and Nicobar Islands,136708,121202,15506,2021-06-20 18:10:17
3849,2,Andhra Pradesh,13940560,11201229,2739331,2021-06-20 18:10:17
3850,3,Arunachal Pradesh,480320,400684,79636,2021-06-20 18:10:17
3851,4,Assam,5360385,4294662,1065723,2021-06-20 18:10:17
3852,5,Bihar,13680378,11630826,2049552,2021-06-20 18:10:17
3853,6,Chandigarh,453577,376354,77223,2021-06-20 18:10:17
3854,7,Chhattisgarh,6380490,5192061,1188429,2021-06-20 18:10:17
3855,8,Dadra and Nagar Haveli,146627,134367,12260,2021-06-20 18:10:17
3856,9,Delhi,6533793,4953785,1580008,2021-06-20 18:10:17
3857,10,Goa,760206,659181,101025,2021-06-20 18:10:17
3858,11,Gujarat,22099535,17278756,4820779,2021-06-20 18:10:17
3859,12,Haryana,7367943,6216032,1151911,2021-06-20 18:10:17
3860,13,Himachal Pradesh,2819998,2379678,440320,2021-06-20 18:10:17
3861,14,Jammu and Kashmir,3970723,3367528,603195,2021-06-20 18:10:17
3862,15,Jharkhand,5778609,4869438,909171,2021-06-20 18:10:17
3863,16,Karnataka,18498363,15268722,3229641,2021-06-20 18:10:17
3864,17,Kerala,12161549,9719116,2442433,2021-06-20 18:10:17
3865,18,Ladakh,199286,161809,37477,2021-06-20 18:10:17
3866,19,Lakshadweep,51507,44347,7160,2021-06-20 18:10:17
3867,20,Madhya Pradesh,15019817,12965037,2054780,2021-06-20 18:10:17
3868,21,Maharashtra,27733974,22244712,5489262,2021-06-20 18:10:17
3869,22,Manipur,565710,493565,72145,2021-06-20 18:10:17
3870,23,Meghalaya,590972,515897,75075,2021-06-20 18:10:17
3871,24,Mizoram,428686,376032,52654,2021-06-20 18:10:17
3872,25,Nagaland,399370,346298,53072,2021-06-20 18:10:17
3873,26,Odisha,9846132,8037617,1808515,2021-06-20 18:10:17
3874,27,Puducherry,418672,362503,56169,2021-06-20 18:10:17
3875,28,Punjab,5422887,4565935,856952,2021-06-20 18:10:17
3876,29,Rajasthan,21238176,17808082,3430094,2021-06-20 18:10:17
3877,30,Sikkim,359435,299524,59911,2021-06-20 18:10:17
3878,31,Tamil Nadu,12701415,10429212,2272203,2021-06-20 18:10:17
3879,32,Telangana,9173921,7785158,1388763,2021-06-20 18:10:17
3880,33,Tripura,1942706,1403613,539093,2021-06-20 18:10:17
3881,34,Uttar Pradesh,25627085,21602698,4024387,2021-06-20 18:10:17
3882,35,Uttarakhand,3556154,2821983,734171,2021-06-20 18:10:17
3883,36,West Bengal,19010947,14736671,4274276,2021-06-20 18:10:17
3884,37,Daman and Diu,162077,147394,14683,2021-06-20 18:10:17
3885,1,Andaman and Nicobar Islands,137495,121964,15531,2021-06-21 18:10:14
3886,2,Andhra Pradesh,14011163,11265333,2745830,2021-06-21 18:10:14
3887,3,Arunachal Pradesh,494030,414267,79763,2021-06-21 18:10:14
3888,4,Assam,5721227,4635279,1085948,2021-06-21 18:10:14
3889,5,Bihar,14235058,12161634,2073424,2021-06-21 18:10:14
3890,6,Chandigarh,460426,382966,77460,2021-06-21 18:10:14
3891,7,Chhattisgarh,6480379,5278123,1202256,2021-06-21 18:10:14
3892,8,Dadra and Nagar Haveli,150810,138512,12298,2021-06-21 18:10:14
3893,9,Delhi,6611234,5013438,1597796,2021-06-21 18:10:14
3894,10,Goa,776098,674546,101552,2021-06-21 18:10:14
3895,11,Gujarat,22619651,17730463,4889188,2021-06-21 18:10:14
3896,12,Haryana,7879825,6690650,1189175,2021-06-21 18:10:14
3897,13,Himachal Pradesh,2918724,2478389,440335,2021-06-21 18:10:14
3898,14,Jammu and Kashmir,4009211,3402011,607200,2021-06-21 18:10:14
3899,15,Jharkhand,5883561,4957150,926411,2021-06-21 18:10:14
3900,16,Karnataka,19652759,16339169,3313590,2021-06-21 18:10:14
3901,17,Kerala,12431202,9878112,2553090,2021-06-21 18:10:14
3902,18,Ladakh,200706,163217,37489,2021-06-21 18:10:14
3903,19,Lakshadweep,52001,44826,7175,2021-06-21 18:10:14
3904,20,Madhya Pradesh,16733198,14594389,2138809,2021-06-21 18:10:14
3905,21,Maharashtra,28128768,22587693,5541075,2021-06-21 18:10:14
3906,22,Manipur,572397,500102,72295,2021-06-21 18:10:14
3907,23,Meghalaya,604195,528959,75236,2021-06-21 18:10:14
3908,24,Mizoram,445820,393007,52813,2021-06-21 18:10:14
3909,25,Nagaland,409572,356362,53210,2021-06-21 18:10:14
3910,26,Odisha,10149548,8309521,1840027,2021-06-21 18:10:14
3911,27,Puducherry,436571,379550,57021,2021-06-21 18:10:14
3912,28,Punjab,5521994,4654728,867266,2021-06-21 18:10:14
3913,29,Rajasthan,21713044,18233535,3479509,2021-06-21 18:10:14
3914,30,Sikkim,371403,311460,59943,2021-06-21 18:10:14
3915,31,Tamil Nadu,13106666,10807056,2299610,2021-06-21 18:10:14
3916,32,Telangana,9327568,7928931,1398637,2021-06-21 18:10:14
3917,33,Tripura,2093251,1549142,544109,2021-06-21 18:10:14
3918,34,Uttar Pradesh,26359410,22296504,4062906,2021-06-21 18:10:14
3919,35,Uttarakhand,3676500,2938547,737953,2021-06-21 18:10:14
3920,36,West Bengal,19349842,14997560,4352282,2021-06-21 18:10:14
3921,37,Daman and Diu,166457,151712,14745,2021-06-21 18:10:14
3922,1,Andaman and Nicobar Islands,140296,124729,15567,2021-06-22 18:14:23
3923,2,Andhra Pradesh,14058162,11306134,2752028,2021-06-22 18:14:23
3924,3,Arunachal Pradesh,505027,425013,80014,2021-06-22 18:14:23
3925,4,Assam,5989078,4885776,1103302,2021-06-22 18:14:23
3926,5,Bihar,14642396,12546864,2095532,2021-06-22 18:14:23
3927,6,Chandigarh,468436,390586,77850,2021-06-22 18:14:23
3928,7,Chhattisgarh,6605593,5386159,1219434,2021-06-22 18:14:23
3929,8,Dadra and Nagar Haveli,154806,142449,12357,2021-06-22 18:14:23
3930,9,Delhi,6697233,5080592,1616641,2021-06-22 18:14:23
3931,10,Goa,791272,688792,102480,2021-06-22 18:14:23
3932,11,Gujarat,23067276,18105136,4962140,2021-06-22 18:14:23
3933,12,Haryana,8011052,6800712,1210340,2021-06-22 18:14:23
3934,13,Himachal Pradesh,3040740,2600380,440360,2021-06-22 18:14:23
3935,14,Jammu and Kashmir,4051418,3439485,611933,2021-06-22 18:14:23
3936,15,Jharkhand,6000196,5055364,944832,2021-06-22 18:14:23
3937,16,Karnataka,20104474,16752226,3352248,2021-06-22 18:14:23
3938,17,Kerala,12668936,10022247,2646689,2021-06-22 18:14:23
3939,18,Ladakh,202329,164799,37530,2021-06-22 18:14:23
3940,19,Lakshadweep,52459,45234,7225,2021-06-22 18:14:23
3941,20,Madhya Pradesh,16803173,14660585,2142588,2021-06-22 18:14:23
3942,21,Maharashtra,28706375,23089545,5616830,2021-06-22 18:14:23
3943,22,Manipur,576461,504048,72413,2021-06-22 18:14:23
3944,23,Meghalaya,617157,541746,75411,2021-06-22 18:14:23
3945,24,Mizoram,473304,420432,52872,2021-06-22 18:14:23
3946,25,Nagaland,419911,366444,53467,2021-06-22 18:14:23
3947,26,Odisha,10441470,8574489,1866981,2021-06-22 18:14:23
3948,27,Puducherry,445363,387363,58000,2021-06-22 18:14:23
3949,28,Punjab,5647031,4764482,882549,2021-06-22 18:14:23
3950,29,Rajasthan,22139075,18591445,3547630,2021-06-22 18:14:23
3951,30,Sikkim,385331,325348,59983,2021-06-22 18:14:23
3952,31,Tamil Nadu,13414792,11092832,2321960,2021-06-22 18:14:23
3953,32,Telangana,9486520,8076582,1409938,2021-06-22 18:14:23
3954,33,Tripura,2285345,1733843,551502,2021-06-22 18:14:23
3955,34,Uttar Pradesh,27232439,23129586,4102853,2021-06-22 18:14:23
3956,35,Uttarakhand,3799085,3056963,742122,2021-06-22 18:14:23
3957,36,West Bengal,19667535,15251854,4415681,2021-06-22 18:14:23
3958,37,Daman and Diu,170200,155252,14948,2021-06-22 18:14:23
3959,1,Andaman and Nicobar Islands,144234,128630,15604,2021-06-23 18:01:52
3960,2,Andhra Pradesh,14091954,11331864,2760090,2021-06-23 18:01:52
3961,3,Arunachal Pradesh,517112,436991,80121,2021-06-23 18:01:52
3962,4,Assam,6354626,5233285,1121341,2021-06-23 18:01:52
3963,5,Bihar,14978417,12863306,2115111,2021-06-23 18:01:52
3964,6,Chandigarh,475527,397301,78226,2021-06-23 18:01:52
3965,7,Chhattisgarh,6783572,5541241,1242331,2021-06-23 18:01:52
3966,8,Dadra and Nagar Haveli,158498,146089,12409,2021-06-23 18:01:52
3967,9,Delhi,6807716,5179708,1628008,2021-06-23 18:01:52
3968,10,Goa,805001,701689,103312,2021-06-23 18:01:52
3969,11,Gujarat,23513610,18475269,5038341,2021-06-23 18:01:52
3970,12,Haryana,8088643,6863194,1225449,2021-06-23 18:01:52
3971,13,Himachal Pradesh,3185389,2744942,440447,2021-06-23 18:01:52
3972,14,Jammu and Kashmir,4119122,3502239,616883,2021-06-23 18:01:52
3973,15,Jharkhand,6131818,5167917,963901,2021-06-23 18:01:52
3974,16,Karnataka,20512334,17126371,3385963,2021-06-23 18:01:52
3975,17,Kerala,12837481,10116957,2720524,2021-06-23 18:01:52
3976,18,Ladakh,203725,166167,37558,2021-06-23 18:01:52
3977,19,Lakshadweep,52829,45566,7263,2021-06-23 18:01:52
3978,20,Madhya Pradesh,17978981,15775623,2203358,2021-06-23 18:01:52
3979,21,Maharashtra,29345261,23663198,5682063,2021-06-23 18:01:52
3980,22,Manipur,582812,510253,72559,2021-06-23 18:01:52
3981,23,Meghalaya,629639,554067,75572,2021-06-23 18:01:52
3982,24,Mizoram,496292,443264,53028,2021-06-23 18:01:52
3983,25,Nagaland,430786,376992,53794,2021-06-23 18:01:52
3984,26,Odisha,10765825,8874332,1891493,2021-06-23 18:01:52
3985,27,Puducherry,454182,394822,59360,2021-06-23 18:01:52
3986,28,Punjab,5736250,4839891,896359,2021-06-23 18:01:52
3987,29,Rajasthan,22498043,18905925,3592118,2021-06-23 18:01:52
3988,30,Sikkim,397182,337151,60031,2021-06-23 18:01:52
3989,31,Tamil Nadu,13636788,11289696,2347092,2021-06-23 18:01:52
3990,32,Telangana,9654533,8233390,1421143,2021-06-23 18:01:52
3991,33,Tripura,2344975,1788351,556624,2021-06-23 18:01:52
3992,34,Uttar Pradesh,28060510,23918186,4142324,2021-06-23 18:01:52
3993,35,Uttarakhand,3922340,3176320,746020,2021-06-23 18:01:52
3994,36,West Bengal,20022881,15536230,4486651,2021-06-23 18:01:52
3995,37,Daman and Diu,173633,158463,15170,2021-06-23 18:01:52
3996,1,Andaman and Nicobar Islands,149318,133533,15785,2021-06-24 18:10:24
3997,2,Andhra Pradesh,14404310,11586263,2818047,2021-06-24 18:10:24
3998,3,Arunachal Pradesh,529176,448592,80584,2021-06-24 18:10:24
3999,4,Assam,6523851,5387805,1136046,2021-06-24 18:10:24
4000,5,Bihar,15264572,13127210,2137362,2021-06-24 18:10:24
4001,6,Chandigarh,482326,403380,78946,2021-06-24 18:10:24
4002,7,Chhattisgarh,7020698,5739810,1280888,2021-06-24 18:10:24
4003,8,Dadra and Nagar Haveli,163091,150258,12833,2021-06-24 18:10:24
4004,9,Delhi,6966205,5318124,1648081,2021-06-24 18:10:24
4005,10,Goa,818202,713714,104488,2021-06-24 18:10:24
4006,11,Gujarat,23968923,18826982,5141941,2021-06-24 18:10:24
4007,12,Haryana,8168749,6928225,1240524,2021-06-24 18:10:24
4008,13,Himachal Pradesh,3223393,2773268,450125,2021-06-24 18:10:24
4009,14,Jammu and Kashmir,4169680,3546680,623000,2021-06-24 18:10:24
4010,15,Jharkhand,6255348,5275892,979456,2021-06-24 18:10:24
4011,16,Karnataka,20921155,17493598,3427557,2021-06-24 18:10:24
4012,17,Kerala,13061640,10258975,2802665,2021-06-24 18:10:24
4013,18,Ladakh,206992,167571,39421,2021-06-24 18:10:24
4014,19,Lakshadweep,53150,45834,7316,2021-06-24 18:10:24
4015,20,Madhya Pradesh,18769872,16512594,2257278,2021-06-24 18:10:24
4016,21,Maharashtra,29788061,24046509,5741552,2021-06-24 18:10:24
4017,22,Manipur,588117,515401,72716,2021-06-24 18:10:24
4018,23,Meghalaya,641778,565784,75994,2021-06-24 18:10:24
4019,24,Mizoram,518600,465500,53100,2021-06-24 18:10:24
4020,25,Nagaland,440810,386200,54610,2021-06-24 18:10:24
4021,26,Odisha,11052797,9126091,1926706,2021-06-24 18:10:24
4022,27,Puducherry,462497,401988,60509,2021-06-24 18:10:24
4023,28,Punjab,5844271,4929959,914312,2021-06-24 18:10:24
4024,29,Rajasthan,22714675,19090259,3624416,2021-06-24 18:10:24
4025,30,Sikkim,409995,349190,60805,2021-06-24 18:10:24
4026,31,Tamil Nadu,14048419,11658908,2389511,2021-06-24 18:10:24
4027,32,Telangana,9865603,8430040,1435563,2021-06-24 18:10:24
4028,33,Tripura,2396775,1834177,562598,2021-06-24 18:10:24
4029,34,Uttar Pradesh,28976470,24782239,4194231,2021-06-24 18:10:24
4030,35,Uttarakhand,4026451,3274993,751458,2021-06-24 18:10:24
4031,36,West Bengal,20352923,15798841,4554082,2021-06-24 18:10:24
4032,37,Daman and Diu,177957,162493,15464,2021-06-24 18:10:24
4033,1,Andaman and Nicobar Islands,154100,138254,15846,2021-06-25 18:07:45
4034,2,Andhra Pradesh,14525647,11681453,2844194,2021-06-25 18:07:45
4035,3,Arunachal Pradesh,540634,459890,80744,2021-06-25 18:07:45
4036,4,Assam,6688421,5535855,1152566,2021-06-25 18:07:45
4037,5,Bihar,15512516,13355865,2156651,2021-06-25 18:07:45
4038,6,Chandigarh,489480,409614,79866,2021-06-25 18:07:45
4039,7,Chhattisgarh,7245933,5918014,1327919,2021-06-25 18:07:45
4040,8,Dadra and Nagar Haveli,168292,154631,13661,2021-06-25 18:07:45
4041,9,Delhi,7121582,5456691,1664891,2021-06-25 18:07:45
4042,10,Goa,833836,728178,105658,2021-06-25 18:07:45
4043,11,Gujarat,24271144,19053252,5217892,2021-06-25 18:07:45
4044,12,Haryana,8314915,7043353,1271562,2021-06-25 18:07:45
4045,13,Himachal Pradesh,3330049,2868066,461983,2021-06-25 18:07:45
4046,14,Jammu and Kashmir,4232071,3602396,629675,2021-06-25 18:07:45
4047,15,Jharkhand,6403158,5408550,994608,2021-06-25 18:07:45
4048,16,Karnataka,21341517,17864741,3476776,2021-06-25 18:07:45
4049,17,Kerala,13304025,10402196,2901829,2021-06-25 18:07:45
4050,18,Ladakh,211520,168168,43352,2021-06-25 18:07:45
4051,19,Lakshadweep,53433,46057,7376,2021-06-25 18:07:45
4052,20,Madhya Pradesh,18801044,16543406,2257638,2021-06-25 18:07:45
4053,21,Maharashtra,30283190,24455767,5827423,2021-06-25 18:07:45
4054,22,Manipur,596468,523660,72808,2021-06-25 18:07:45
4055,23,Meghalaya,655138,578927,76211,2021-06-25 18:07:45
4056,24,Mizoram,540516,487321,53195,2021-06-25 18:07:45
4057,25,Nagaland,452837,398041,54796,2021-06-25 18:07:45
4058,26,Odisha,11295459,9327880,1967579,2021-06-25 18:07:45
4059,27,Puducherry,469829,408440,61389,2021-06-25 18:07:45
4060,28,Punjab,5972116,5036271,935845,2021-06-25 18:07:45
4061,29,Rajasthan,23669169,19929199,3739970,2021-06-25 18:07:45
4062,30,Sikkim,423563,362037,61526,2021-06-25 18:07:45
4063,31,Tamil Nadu,14478557,12056330,2422227,2021-06-25 18:07:45
4064,32,Telangana,10082372,8632930,1449442,2021-06-25 18:07:45
4065,33,Tripura,2428555,1861984,566571,2021-06-25 18:07:45
4066,34,Uttar Pradesh,29857504,25598956,4258548,2021-06-25 18:07:45
4067,35,Uttarakhand,4124177,3365897,758280,2021-06-25 18:07:45
4068,36,West Bengal,20739972,16098954,4641018,2021-06-25 18:07:45
4069,37,Daman and Diu,189780,173776,16004,2021-06-25 18:07:45
4070,1,Andaman and Nicobar Islands,159630,143329,16301,2021-06-26 18:11:03
4071,2,Andhra Pradesh,14827546,11920947,2906599,2021-06-26 18:11:03
4072,3,Arunachal Pradesh,551507,470168,81339,2021-06-26 18:11:03
4073,4,Assam,6841405,5658679,1182726,2021-06-26 18:11:03
4074,5,Bihar,15683198,13508016,2175182,2021-06-26 18:11:03
4075,6,Chandigarh,498862,417304,81558,2021-06-26 18:11:03
4076,7,Chhattisgarh,7602182,6211885,1390297,2021-06-26 18:11:03
4077,8,Dadra and Nagar Haveli,175608,160664,14944,2021-06-26 18:11:03
4078,9,Delhi,7329652,5629446,1700206,2021-06-26 18:11:03
4079,10,Goa,856142,748351,107791,2021-06-26 18:11:03
4080,11,Gujarat,24657300,19330981,5326319,2021-06-26 18:11:03
4081,12,Haryana,8430740,7132701,1298039,2021-06-26 18:11:03
4082,13,Himachal Pradesh,3482066,3010202,471864,2021-06-26 18:11:03
4083,14,Jammu and Kashmir,4282658,3643605,639053,2021-06-26 18:11:03
4084,15,Jharkhand,6547873,5536533,1011340,2021-06-26 18:11:03
4085,16,Karnataka,21622289,18089135,3533154,2021-06-26 18:11:03
4086,17,Kerala,13483338,10506089,2977249,2021-06-26 18:11:03
4087,18,Ladakh,215964,168671,47293,2021-06-26 18:11:03
4088,19,Lakshadweep,53736,46253,7483,2021-06-26 18:11:03
4089,20,Madhya Pradesh,19801236,17444479,2356757,2021-06-26 18:11:03
4090,21,Maharashtra,31032178,25046626,5985552,2021-06-26 18:11:03
4091,22,Manipur,603780,530732,73048,2021-06-26 18:11:03
4092,23,Meghalaya,663542,587037,76505,2021-06-26 18:11:03
4093,24,Mizoram,550381,497141,53240,2021-06-26 18:11:03
4094,25,Nagaland,458432,403587,54845,2021-06-26 18:11:03
4095,26,Odisha,11539203,9516596,2022607,2021-06-26 18:11:03
4096,27,Puducherry,479491,416622,62869,2021-06-26 18:11:03
4097,28,Punjab,6114078,5146916,967162,2021-06-26 18:11:03
4098,29,Rajasthan,23987142,20190615,3796527,2021-06-26 18:11:03
4099,30,Sikkim,433131,371534,61597,2021-06-26 18:11:03
4100,31,Tamil Nadu,14890041,12420061,2469980,2021-06-26 18:11:03
4101,32,Telangana,10326965,8850210,1476755,2021-06-26 18:11:03
4102,33,Tripura,2467674,1894007,573667,2021-06-26 18:11:03
4103,34,Uttar Pradesh,30451330,26129782,4321548,2021-06-26 18:11:03
4104,35,Uttarakhand,4193872,3425878,767994,2021-06-26 18:11:03
4105,36,West Bengal,21043842,16320306,4723536,2021-06-26 18:11:03
4106,37,Daman and Diu,197761,180795,16966,2021-06-26 18:11:03
4107,1,Andaman and Nicobar Islands,161325,145019,16306,2021-06-27 18:23:18
4108,2,Andhra Pradesh,14868799,11958632,2910167,2021-06-27 18:23:18
4109,3,Arunachal Pradesh,557701,475866,81835,2021-06-27 18:23:18
4110,4,Assam,6854797,5668536,1186261,2021-06-27 18:23:18
4111,5,Bihar,15744915,13562883,2182032,2021-06-27 18:23:18
4112,6,Chandigarh,504126,421745,82381,2021-06-27 18:23:18
4113,7,Chhattisgarh,7821930,6380368,1441562,2021-06-27 18:23:18
4114,8,Dadra and Nagar Haveli,178760,163103,15657,2021-06-27 18:23:18
4115,9,Delhi,7339238,5636415,1702823,2021-06-27 18:23:18
4116,10,Goa,871472,762729,108743,2021-06-27 18:23:18
4117,11,Gujarat,24887523,19500271,5387252,2021-06-27 18:23:18
4118,12,Haryana,8473361,7166083,1307278,2021-06-27 18:23:18
4119,13,Himachal Pradesh,3497784,3025895,471889,2021-06-27 18:23:18
4120,14,Jammu and Kashmir,4344943,3699377,645566,2021-06-27 18:23:18
4121,15,Jharkhand,6668652,5640086,1028566,2021-06-27 18:23:18
4122,16,Karnataka,21750366,18196068,3554298,2021-06-27 18:23:18
4123,17,Kerala,13535878,10541450,2994428,2021-06-27 18:23:18
4124,18,Ladakh,216616,168691,47925,2021-06-27 18:23:18
4125,19,Lakshadweep,53855,46340,7515,2021-06-27 18:23:18
4126,20,Madhya Pradesh,19826706,17466782,2359924,2021-06-27 18:23:18
4127,21,Maharashtra,31158987,25144877,6014110,2021-06-27 18:23:18
4128,22,Manipur,606673,533606,73067,2021-06-27 18:23:18
4129,23,Meghalaya,664291,587769,76522,2021-06-27 18:23:18
4130,24,Mizoram,550596,497356,53240,2021-06-27 18:23:18
4131,25,Nagaland,462512,407643,54869,2021-06-27 18:23:18
4132,26,Odisha,11571633,9541199,2030434,2021-06-27 18:23:18
4133,27,Puducherry,481902,418640,63262,2021-06-27 18:23:18
4134,28,Punjab,6182574,5204384,978190,2021-06-27 18:23:18
4135,29,Rajasthan,24251293,20412715,3838578,2021-06-27 18:23:18
4136,30,Sikkim,433136,371539,61597,2021-06-27 18:23:18
4137,31,Tamil Nadu,15021946,12535263,2486683,2021-06-27 18:23:18
4138,32,Telangana,10431095,8945567,1485528,2021-06-27 18:23:18
4139,33,Tripura,2474475,1899573,574902,2021-06-27 18:23:18
4140,34,Uttar Pradesh,30479424,26154179,4325245,2021-06-27 18:23:18
4141,35,Uttarakhand,4214564,3443111,771453,2021-06-27 18:23:18
4142,36,West Bengal,21128717,16382560,4746157,2021-06-27 18:23:18
4143,37,Daman and Diu,200927,183618,17309,2021-06-27 18:23:18
4144,1,Andaman and Nicobar Islands,165921,148486,17435,2021-06-28 18:02:13
4145,2,Andhra Pradesh,15094679,12120023,2974656,2021-06-28 18:02:13
4146,3,Arunachal Pradesh,573002,490029,82973,2021-06-28 18:02:13
4147,4,Assam,6976615,5765156,1211459,2021-06-28 18:02:13
4148,5,Bihar,15802730,13608219,2194511,2021-06-28 18:02:13
4149,6,Chandigarh,511843,427780,84063,2021-06-28 18:02:13
4150,7,Chhattisgarh,8104281,6602957,1501324,2021-06-28 18:02:13
4151,8,Dadra and Nagar Haveli,187133,170103,17030,2021-06-28 18:02:13
4152,9,Delhi,7543922,5801102,1742820,2021-06-28 18:02:13
4153,10,Goa,892220,781063,111157,2021-06-28 18:02:13
4154,11,Gujarat,25141162,19683467,5457695,2021-06-28 18:02:13
4155,12,Haryana,8616321,7268600,1347721,2021-06-28 18:02:13
4156,13,Himachal Pradesh,3666915,3187698,479217,2021-06-28 18:02:13
4157,14,Jammu and Kashmir,4416417,3758141,658276,2021-06-28 18:02:13
4158,15,Jharkhand,6770349,5724536,1045813,2021-06-28 18:02:13
4159,16,Karnataka,22202542,18563185,3639357,2021-06-28 18:02:13
4160,17,Kerala,13748651,10649612,3099039,2021-06-28 18:02:13
4161,18,Ladakh,220989,169421,51568,2021-06-28 18:02:13
4162,19,Lakshadweep,54138,46494,7644,2021-06-28 18:02:13
4163,20,Madhya Pradesh,20289692,17897347,2392345,2021-06-28 18:02:13
4164,21,Maharashtra,31781730,25598367,6183363,2021-06-28 18:02:13
4165,22,Manipur,621399,548026,73373,2021-06-28 18:02:13
4166,23,Meghalaya,678691,601229,77462,2021-06-28 18:02:13
4167,24,Mizoram,559934,506474,53460,2021-06-28 18:02:13
4168,25,Nagaland,475119,419127,55992,2021-06-28 18:02:13
4169,26,Odisha,11832106,9732379,2099727,2021-06-28 18:02:13
4170,27,Puducherry,492598,427897,64701,2021-06-28 18:02:13
4171,28,Punjab,6230597,5242562,988035,2021-06-28 18:02:13
4172,29,Rajasthan,24438759,20555847,3882912,2021-06-28 18:02:13
4173,30,Sikkim,448770,384196,64574,2021-06-28 18:02:13
4174,31,Tamil Nadu,15231397,12716906,2514491,2021-06-28 18:02:13
4175,32,Telangana,10654325,9139505,1514820,2021-06-28 18:02:13
4176,33,Tripura,2510943,1926146,584797,2021-06-28 18:02:13
4177,34,Uttar Pradesh,31002019,26591964,4410055,2021-06-28 18:02:13
4178,35,Uttarakhand,4262996,3478499,784497,2021-06-28 18:02:13
4179,36,West Bengal,21427071,16563389,4863682,2021-06-28 18:02:13
4180,37,Daman and Diu,208353,189857,18496,2021-06-28 18:02:13
4181,1,Andaman and Nicobar Islands,171590,153048,18542,2021-06-29 18:02:20
4182,2,Andhra Pradesh,15389049,12346836,3042213,2021-06-29 18:02:20
4183,3,Arunachal Pradesh,580543,496811,83732,2021-06-29 18:02:20
4184,4,Assam,7008658,5785111,1223547,2021-06-29 18:02:20
4185,5,Bihar,15856079,13650265,2205814,2021-06-29 18:02:20
4186,6,Chandigarh,519880,434020,85860,2021-06-29 18:02:20
4187,7,Chhattisgarh,8313712,6766414,1547298,2021-06-29 18:02:20
4188,8,Dadra and Nagar Haveli,196098,177818,18280,2021-06-29 18:02:20
4189,9,Delhi,7747246,5967019,1780227,2021-06-29 18:02:20
4190,10,Goa,914013,800268,113745,2021-06-29 18:02:20
4191,11,Gujarat,25408616,19872911,5535705,2021-06-29 18:02:20
4192,12,Haryana,8754231,7365625,1388606,2021-06-29 18:02:20
4193,13,Himachal Pradesh,3827079,3338511,488568,2021-06-29 18:02:20
4194,14,Jammu and Kashmir,4467382,3801390,665992,2021-06-29 18:02:20
4195,15,Jharkhand,6830286,5771964,1058322,2021-06-29 18:02:20
4196,16,Karnataka,22470761,18787206,3683555,2021-06-29 18:02:20
4197,17,Kerala,13948645,10748505,3200140,2021-06-29 18:02:20
4198,18,Ladakh,224630,170297,54333,2021-06-29 18:02:20
4199,19,Lakshadweep,54662,46750,7912,2021-06-29 18:02:20
4200,20,Madhya Pradesh,20303352,17909367,2393985,2021-06-29 18:02:20
4201,21,Maharashtra,32178658,25883793,6294865,2021-06-29 18:02:20
4202,22,Manipur,637207,563425,73782,2021-06-29 18:02:20
4203,23,Meghalaya,690638,612010,78628,2021-06-29 18:02:20
4204,24,Mizoram,568598,514605,53993,2021-06-29 18:02:20
4205,25,Nagaland,487762,429862,57900,2021-06-29 18:02:20
4206,26,Odisha,11960777,9824050,2136727,2021-06-29 18:02:20
4207,27,Puducherry,499979,434377,65602,2021-06-29 18:02:20
4208,28,Punjab,6265875,5269832,996043,2021-06-29 18:02:20
4209,29,Rajasthan,24548916,20634921,3913995,2021-06-29 18:02:20
4210,30,Sikkim,462454,394505,67949,2021-06-29 18:02:20
4211,31,Tamil Nadu,15510424,12963745,2546679,2021-06-29 18:02:20
4212,32,Telangana,10874672,9329183,1545489,2021-06-29 18:02:20
4213,33,Tripura,2536995,1946066,590929,2021-06-29 18:02:20
4214,34,Uttar Pradesh,31209641,26740850,4468791,2021-06-29 18:02:20
4215,35,Uttarakhand,4339656,3536398,803258,2021-06-29 18:02:20
4216,36,West Bengal,21711965,16729378,4982587,2021-06-29 18:02:20
4217,37,Daman and Diu,214693,195088,19605,2021-06-29 18:02:20
4218,1,Andaman and Nicobar Islands,176293,156470,19823,2021-06-30 18:01:45
4219,2,Andhra Pradesh,15703354,12587352,3116002,2021-06-30 18:01:45
4220,3,Arunachal Pradesh,593355,508826,84529,2021-06-30 18:01:45
4221,4,Assam,7022922,5792056,1230866,2021-06-30 18:01:45
4222,5,Bihar,15899022,13683539,2215483,2021-06-30 18:01:45
4223,6,Chandigarh,526877,439301,87576,2021-06-30 18:01:45
4224,7,Chhattisgarh,8453345,6879610,1573735,2021-06-30 18:01:45
4225,8,Dadra and Nagar Haveli,205053,185824,19229,2021-06-30 18:01:45
4226,9,Delhi,7893534,6088879,1804655,2021-06-30 18:01:45
4227,10,Goa,934022,817485,116537,2021-06-30 18:01:45
4228,11,Gujarat,25692042,20070872,5621170,2021-06-30 18:01:45
4229,12,Haryana,8856678,7433613,1423065,2021-06-30 18:01:45
4230,13,Himachal Pradesh,3866287,3351501,514786,2021-06-30 18:01:45
4231,14,Jammu and Kashmir,4525535,3844705,680830,2021-06-30 18:01:45
4232,15,Jharkhand,6854142,5789884,1064258,2021-06-30 18:01:45
4233,16,Karnataka,22712414,18973039,3739375,2021-06-30 18:01:45
4234,17,Kerala,14095726,10841514,3254212,2021-06-30 18:01:45
4235,18,Ladakh,226801,170900,55901,2021-06-30 18:01:45
4236,19,Lakshadweep,54700,46779,7921,2021-06-30 18:01:45
4237,20,Madhya Pradesh,20314158,17917782,2396376,2021-06-30 18:01:45
4238,21,Maharashtra,32439568,26067743,6371825,2021-06-30 18:01:45
4239,22,Manipur,655247,581109,74138,2021-06-30 18:01:45
4240,23,Meghalaya,699213,619732,79481,2021-06-30 18:01:45
4241,24,Mizoram,573048,518679,54369,2021-06-30 18:01:45
4242,25,Nagaland,500218,440344,59874,2021-06-30 18:01:45
4243,26,Odisha,12016338,9868098,2148240,2021-06-30 18:01:45
4244,27,Puducherry,507468,440363,67105,2021-06-30 18:01:45
4245,28,Punjab,6292478,5289807,1002671,2021-06-30 18:01:45
4246,29,Rajasthan,24731046,20750495,3980551,2021-06-30 18:01:45
4247,30,Sikkim,473810,401506,72304,2021-06-30 18:01:45
4248,31,Tamil Nadu,15642085,13072807,2569278,2021-06-30 18:01:45
4249,32,Telangana,11071415,9493724,1577691,2021-06-30 18:01:45
4250,33,Tripura,2550343,1955929,594414,2021-06-30 18:01:45
4251,34,Uttar Pradesh,31281400,26792784,4488616,2021-06-30 18:01:45
4252,35,Uttarakhand,4401789,3579832,821957,2021-06-30 18:01:45
4253,36,West Bengal,21889622,16833029,5056593,2021-06-30 18:01:45
4254,37,Daman and Diu,222275,201269,21006,2021-06-30 18:01:45
4255,1,Andaman and Nicobar Islands,178502,157304,21198,2021-07-01 18:14:13
4256,2,Andhra Pradesh,15985323,12805075,3180248,2021-07-01 18:14:13
4257,3,Arunachal Pradesh,604172,518465,85707,2021-07-01 18:14:13
4258,4,Assam,7206783,5957147,1249636,2021-07-01 18:14:13
4259,5,Bihar,16116113,13863804,2252309,2021-07-01 18:14:13
4260,6,Chandigarh,533897,444544,89353,2021-07-01 18:14:13
4261,7,Chhattisgarh,8588153,6996558,1591595,2021-07-01 18:14:13
4262,8,Dadra and Nagar Haveli,212762,192411,20351,2021-07-01 18:14:13
4263,9,Delhi,8051352,6214708,1836644,2021-07-01 18:14:13
4264,10,Goa,946993,827800,119193,2021-07-01 18:14:13
4265,11,Gujarat,25973769,20266271,5707498,2021-07-01 18:14:13
4266,12,Haryana,9052429,7584644,1467785,2021-07-01 18:14:13
4267,13,Himachal Pradesh,3908924,3362065,546859,2021-07-01 18:14:13
4268,14,Jammu and Kashmir,4570376,3876688,693688,2021-07-01 18:14:13
4269,15,Jharkhand,6893417,5821359,1072058,2021-07-01 18:14:13
4270,16,Karnataka,22911665,19124712,3786953,2021-07-01 18:14:13
4271,17,Kerala,14242696,10915717,3326979,2021-07-01 18:14:13
4272,18,Ladakh,228809,171439,57370,2021-07-01 18:14:13
4273,19,Lakshadweep,54928,46901,8027,2021-07-01 18:14:13
4274,20,Madhya Pradesh,21302275,18757527,2544748,2021-07-01 18:14:13
4275,21,Maharashtra,32720630,26252541,6468089,2021-07-01 18:14:13
4276,22,Manipur,672166,597706,74460,2021-07-01 18:14:13
4277,23,Meghalaya,712223,631279,80944,2021-07-01 18:14:13
4278,24,Mizoram,580553,524954,55599,2021-07-01 18:14:13
4279,25,Nagaland,509293,447302,61991,2021-07-01 18:14:13
4280,26,Odisha,12055072,9899612,2155460,2021-07-01 18:14:13
4281,27,Puducherry,513535,445152,68383,2021-07-01 18:14:13
4282,28,Punjab,6314228,5307013,1007215,2021-07-01 18:14:13
4283,29,Rajasthan,24802226,20795259,4006967,2021-07-01 18:14:13
4284,30,Sikkim,483470,407286,76184,2021-07-01 18:14:13
4285,31,Tamil Nadu,15859592,13260693,2598899,2021-07-01 18:14:13
4286,32,Telangana,11240416,9636141,1604275,2021-07-01 18:14:13
4287,33,Tripura,2568901,1969442,599459,2021-07-01 18:14:13
4288,34,Uttar Pradesh,31633572,27047411,4586161,2021-07-01 18:14:13
4289,35,Uttarakhand,4446547,3609832,836715,2021-07-01 18:14:13
4290,36,West Bengal,22009840,16900071,5109769,2021-07-01 18:14:13
4291,37,Daman and Diu,227618,205545,22073,2021-07-01 18:14:13
4292,1,Andaman and Nicobar Islands,181221,158335,22886,2021-07-02 18:06:29
4293,2,Andhra Pradesh,16331596,13098513,3233083,2021-07-02 18:06:29
4294,3,Arunachal Pradesh,614505,527034,87471,2021-07-02 18:06:29
4295,4,Assam,7445311,6169491,1275820,2021-07-02 18:06:29
4296,5,Bihar,16716028,14384051,2331977,2021-07-02 18:06:29
4297,6,Chandigarh,541103,449392,91711,2021-07-02 18:06:29
4298,7,Chhattisgarh,8680874,7076496,1604378,2021-07-02 18:06:29
4299,8,Dadra and Nagar Haveli,221438,199967,21471,2021-07-02 18:06:29
4300,9,Delhi,8212088,6345189,1866899,2021-07-02 18:06:29
4301,10,Goa,960730,837780,122950,2021-07-02 18:06:29
4302,11,Gujarat,26219791,20427199,5792592,2021-07-02 18:06:29
4303,12,Haryana,9220204,7705597,1514607,2021-07-02 18:06:29
4304,13,Himachal Pradesh,3947386,3370592,576794,2021-07-02 18:06:29
4305,14,Jammu and Kashmir,4670310,3948339,721971,2021-07-02 18:06:29
4306,15,Jharkhand,6924097,5846418,1077679,2021-07-02 18:06:29
4307,16,Karnataka,23152094,19293267,3858827,2021-07-02 18:06:29
4308,17,Kerala,14531577,11043945,3487632,2021-07-02 18:06:29
4309,18,Ladakh,230087,172099,57988,2021-07-02 18:06:29
4310,19,Lakshadweep,55294,47042,8252,2021-07-02 18:06:29
4311,20,Madhya Pradesh,21326909,18778322,2548587,2021-07-02 18:06:29
4312,21,Maharashtra,33109808,26512487,6597321,2021-07-02 18:06:29
4313,22,Manipur,695544,620451,75093,2021-07-02 18:06:29
4314,23,Meghalaya,724020,641366,82654,2021-07-02 18:06:29
4315,24,Mizoram,592671,534949,57722,2021-07-02 18:06:29
4316,25,Nagaland,518347,454265,64082,2021-07-02 18:06:29
4317,26,Odisha,12089892,9927123,2162769,2021-07-02 18:06:29
4318,27,Puducherry,518831,448960,69871,2021-07-02 18:06:29
4319,28,Punjab,6346355,5327984,1018371,2021-07-02 18:06:29
4320,29,Rajasthan,24887697,20857470,4030227,2021-07-02 18:06:29
4321,30,Sikkim,493534,411724,81810,2021-07-02 18:06:29
4322,31,Tamil Nadu,16171046,13523115,2647931,2021-07-02 18:06:29
4323,32,Telangana,11423209,9783478,1639731,2021-07-02 18:06:29
4324,33,Tripura,2595949,1987663,608286,2021-07-02 18:06:29
4325,34,Uttar Pradesh,32067268,27363633,4703635,2021-07-02 18:06:29
4326,35,Uttarakhand,4479447,3631790,847657,2021-07-02 18:06:29
4327,36,West Bengal,22319689,17019095,5300594,2021-07-02 18:06:29
4328,37,Daman and Diu,231118,207893,23225,2021-07-02 18:06:29
4329,1,Andaman and Nicobar Islands,184103,159330,24773,2021-07-03 18:14:18
4330,2,Andhra Pradesh,16441282,13172868,3268414,2021-07-03 18:14:18
4331,3,Arunachal Pradesh,623711,534250,89461,2021-07-03 18:14:18
4332,4,Assam,7597121,6302541,1294580,2021-07-03 18:14:18
4333,5,Bihar,17118573,14723129,2395444,2021-07-03 18:14:18
4334,6,Chandigarh,551586,456634,94952,2021-07-03 18:14:18
4335,7,Chhattisgarh,8823500,7167424,1656076,2021-07-03 18:14:18
4336,8,Dadra and Nagar Haveli,230684,207936,22748,2021-07-03 18:14:18
4337,9,Delhi,8373332,6466496,1906836,2021-07-03 18:14:18
4338,10,Goa,980683,852875,127808,2021-07-03 18:14:18
4339,11,Gujarat,26552791,20653026,5899765,2021-07-03 18:14:18
4340,12,Haryana,9360295,7805669,1554626,2021-07-03 18:14:18
4341,13,Himachal Pradesh,3985889,3378237,607652,2021-07-03 18:14:18
4342,14,Jammu and Kashmir,4759759,4013073,746686,2021-07-03 18:14:18
4343,15,Jharkhand,7059365,5948380,1110985,2021-07-03 18:14:18
4344,16,Karnataka,23639206,19601804,4037402,2021-07-03 18:14:18
4345,17,Kerala,14764538,11162817,3601721,2021-07-03 18:14:18
4346,18,Ladakh,232133,173803,58330,2021-07-03 18:14:18
4347,19,Lakshadweep,55632,47084,8548,2021-07-03 18:14:18
4348,20,Madhya Pradesh,21594951,18782476,2812475,2021-07-03 18:14:18
4349,21,Maharashtra,33928829,27072332,6856497,2021-07-03 18:14:18
4350,22,Manipur,719567,643877,75690,2021-07-03 18:14:18
4351,23,Meghalaya,733404,649906,83498,2021-07-03 18:14:18
4352,24,Mizoram,600166,540493,59673,2021-07-03 18:14:18
4353,25,Nagaland,520859,456392,64467,2021-07-03 18:14:18
4354,26,Odisha,12202018,9995817,2206201,2021-07-03 18:14:18
4355,27,Puducherry,526345,454281,72064,2021-07-03 18:14:18
4356,28,Punjab,6894264,5710932,1183332,2021-07-03 18:14:18
4357,29,Rajasthan,25666108,21329040,4337068,2021-07-03 18:14:18
4358,30,Sikkim,501578,416397,85181,2021-07-03 18:14:18
4359,31,Tamil Nadu,16636165,13922204,2713961,2021-07-03 18:14:18
4360,32,Telangana,11631502,9939364,1692138,2021-07-03 18:14:18
4361,33,Tripura,2613487,1998901,614586,2021-07-03 18:14:18
4362,34,Uttar Pradesh,32596520,27776672,4819848,2021-07-03 18:14:18
4363,35,Uttarakhand,4527294,3664283,863011,2021-07-03 18:14:18
4364,36,West Bengal,22591117,17135494,5455623,2021-07-03 18:14:18
4365,37,Daman and Diu,235665,210780,24885,2021-07-03 18:14:18
4366,1,Andaman and Nicobar Islands,184515,159342,25173,2021-07-04 18:02:18
4367,2,Andhra Pradesh,16459822,13188358,3271464,2021-07-04 18:02:18
4368,3,Arunachal Pradesh,629024,538776,90248,2021-07-04 18:02:18
4369,4,Assam,7629506,6329978,1299528,2021-07-04 18:02:18
4370,5,Bihar,17255736,14835284,2420452,2021-07-04 18:02:18
4371,6,Chandigarh,558150,461440,96710,2021-07-04 18:02:18
4372,7,Chhattisgarh,8904745,7217817,1686928,2021-07-04 18:02:18
4373,8,Dadra and Nagar Haveli,234472,211206,23266,2021-07-04 18:02:18
4374,9,Delhi,8382839,6472151,1910688,2021-07-04 18:02:18
4375,10,Goa,990480,859902,130578,2021-07-04 18:02:18
4376,11,Gujarat,26815799,20835546,5980253,2021-07-04 18:02:18
4377,12,Haryana,9409759,7840063,1569696,2021-07-04 18:02:18
4378,13,Himachal Pradesh,3986005,3378319,607686,2021-07-04 18:02:18
4379,14,Jammu and Kashmir,4805884,4051232,754652,2021-07-04 18:02:18
4380,15,Jharkhand,7199780,6053155,1146625,2021-07-04 18:02:18
4381,16,Karnataka,23790590,19703988,4086602,2021-07-04 18:02:18
4382,17,Kerala,14790452,11179952,3610500,2021-07-04 18:02:18
4383,18,Ladakh,232795,174447,58348,2021-07-04 18:02:18
4384,19,Lakshadweep,55674,47084,8590,2021-07-04 18:02:18
4385,20,Madhya Pradesh,21602436,18783420,2819016,2021-07-04 18:02:18
4386,21,Maharashtra,34076028,27181244,6894784,2021-07-04 18:02:18
4387,22,Manipur,729209,653287,75922,2021-07-04 18:02:18
4388,23,Meghalaya,734356,650477,83879,2021-07-04 18:02:18
4389,24,Mizoram,600379,540706,59673,2021-07-04 18:02:18
4390,25,Nagaland,526913,461485,65428,2021-07-04 18:02:18
4391,26,Odisha,12237284,10017218,2220066,2021-07-04 18:02:18
4392,27,Puducherry,529509,455749,73760,2021-07-04 18:02:18
4393,28,Punjab,7017721,5800293,1217428,2021-07-04 18:02:18
4394,29,Rajasthan,25769650,21401946,4367704,2021-07-04 18:02:18
4395,30,Sikkim,501580,416397,85183,2021-07-04 18:02:18
4396,31,Tamil Nadu,16747198,14014851,2732347,2021-07-04 18:02:18
4397,32,Telangana,11648353,9945428,1702925,2021-07-04 18:02:18
4398,33,Tripura,2615391,2000280,615111,2021-07-04 18:02:18
4399,34,Uttar Pradesh,32629055,27802518,4826537,2021-07-04 18:02:18
4400,35,Uttarakhand,4588910,3710330,878580,2021-07-04 18:02:18
4401,36,West Bengal,22660276,17165989,5494287,2021-07-04 18:02:18
4402,37,Daman and Diu,235972,210825,25147,2021-07-04 18:02:18
4403,1,Andaman and Nicobar Islands,189428,160292,29136,2021-07-05 18:10:59
4404,2,Andhra Pradesh,16582123,13264570,3317553,2021-07-05 18:10:59
4405,3,Arunachal Pradesh,643509,549526,93983,2021-07-05 18:10:59
4406,4,Assam,7690157,6380179,1309978,2021-07-05 18:10:59
4407,5,Bihar,17384095,14935067,2449028,2021-07-05 18:10:59
4408,6,Chandigarh,566601,467197,99404,2021-07-05 18:10:59
4409,7,Chhattisgarh,9001750,7279827,1721923,2021-07-05 18:10:59
4410,8,Dadra and Nagar Haveli,242422,218210,24212,2021-07-05 18:10:59
4411,9,Delhi,8463689,6523882,1939807,2021-07-05 18:10:59
4412,10,Goa,1006988,870453,136535,2021-07-05 18:10:59
4413,11,Gujarat,27118289,21037286,6081003,2021-07-05 18:10:59
4414,12,Haryana,9515937,7907719,1608218,2021-07-05 18:10:59
4415,13,Himachal Pradesh,4047093,3387795,659298,2021-07-05 18:10:59
4416,14,Jammu and Kashmir,4872354,4101877,770477,2021-07-05 18:10:59
4417,15,Jharkhand,7301080,6126833,1174247,2021-07-05 18:10:59
4418,16,Karnataka,24185562,19965810,4219752,2021-07-05 18:10:59
4419,17,Kerala,14947001,11261270,3685731,2021-07-05 18:10:59
4420,18,Ladakh,235427,176300,59127,2021-07-05 18:10:59
4421,19,Lakshadweep,56206,47243,8963,2021-07-05 18:10:59
4422,20,Madhya Pradesh,22016213,18788825,3227388,2021-07-05 18:10:59
4423,21,Maharashtra,34404490,27418175,6986315,2021-07-05 18:10:59
4424,22,Manipur,759423,681970,77453,2021-07-05 18:10:59
4425,23,Meghalaya,747397,661498,85899,2021-07-05 18:10:59
4426,24,Mizoram,611825,548862,62963,2021-07-05 18:10:59
4427,25,Nagaland,538942,469971,68971,2021-07-05 18:10:59
4428,26,Odisha,12586866,10217642,2369224,2021-07-05 18:10:59
4429,27,Puducherry,539096,460594,78502,2021-07-05 18:10:59
4430,28,Punjab,7070442,5835504,1234938,2021-07-05 18:10:59
4431,29,Rajasthan,25821446,21436551,4384895,2021-07-05 18:10:59
4432,30,Sikkim,515248,423054,92194,2021-07-05 18:10:59
4433,31,Tamil Nadu,16920558,14153278,2767280,2021-07-05 18:10:59
4434,32,Telangana,11830169,10077461,1752708,2021-07-05 18:10:59
4435,33,Tripura,2630048,2009213,620835,2021-07-05 18:10:59
4436,34,Uttar Pradesh,33483868,28472822,5011046,2021-07-05 18:10:59
4437,35,Uttarakhand,4687985,3774218,913767,2021-07-05 18:10:59
4438,36,West Bengal,22960000,17285927,5674073,2021-07-05 18:10:59
4439,37,Daman and Diu,238562,211907,26655,2021-07-05 18:10:59
4440,1,Andaman and Nicobar Islands,196475,161400,35075,2021-07-06 18:01:44
4441,2,Andhra Pradesh,16633924,13298596,3335328,2021-07-06 18:01:44
4442,3,Arunachal Pradesh,654032,556622,97410,2021-07-06 18:01:44
4443,4,Assam,7712614,6396900,1315714,2021-07-06 18:01:44
4444,5,Bihar,17526845,15046903,2479942,2021-07-06 18:01:44
4445,6,Chandigarh,574184,472038,102146,2021-07-06 18:01:44
4446,7,Chhattisgarh,9044519,7307678,1736841,2021-07-06 18:01:44
4447,8,Dadra and Nagar Haveli,249703,224468,25235,2021-07-06 18:01:44
4448,9,Delhi,8498379,6543046,1955333,2021-07-06 18:01:44
4449,10,Goa,1021435,880174,141261,2021-07-06 18:01:44
4450,11,Gujarat,27331752,21181190,6150562,2021-07-06 18:01:44
4451,12,Haryana,9581886,7948436,1633450,2021-07-06 18:01:44
4452,13,Himachal Pradesh,4115822,3398020,717802,2021-07-06 18:01:44
4453,14,Jammu and Kashmir,4928467,4147987,780480,2021-07-06 18:01:44
4454,15,Jharkhand,7444490,6227928,1216562,2021-07-06 18:01:44
4455,16,Karnataka,24477242,20169876,4307366,2021-07-06 18:01:44
4456,17,Kerala,15062316,11322761,3739555,2021-07-06 18:01:44
4457,18,Ladakh,237455,177760,59695,2021-07-06 18:01:44
4458,19,Lakshadweep,56755,47468,9287,2021-07-06 18:01:44
4459,20,Madhya Pradesh,22028495,18792034,3236461,2021-07-06 18:01:44
4460,21,Maharashtra,34802542,27659911,7142631,2021-07-06 18:01:44
4461,22,Manipur,785691,706878,78813,2021-07-06 18:01:44
4462,23,Meghalaya,763595,674827,88768,2021-07-06 18:01:44
4463,24,Mizoram,620536,554889,65647,2021-07-06 18:01:44
4464,25,Nagaland,552125,478508,73617,2021-07-06 18:01:44
4465,26,Odisha,12923503,10418842,2504661,2021-07-06 18:01:44
4466,27,Puducherry,548593,463933,84660,2021-07-06 18:01:44
4467,28,Punjab,7095644,5853013,1242631,2021-07-06 18:01:44
4468,29,Rajasthan,25848234,21454435,4393799,2021-07-06 18:01:44
4469,30,Sikkim,527470,428512,98958,2021-07-06 18:01:44
4470,31,Tamil Nadu,17017222,14224524,2792698,2021-07-06 18:01:44
4471,32,Telangana,11966330,10173744,1792586,2021-07-06 18:01:44
4472,33,Tripura,2642602,2017943,624659,2021-07-06 18:01:44
4473,34,Uttar Pradesh,34513734,29305008,5208726,2021-07-06 18:01:44
4474,35,Uttarakhand,4762569,3821058,941511,2021-07-06 18:01:44
4475,36,West Bengal,23205213,17382673,5822540,2021-07-06 18:01:44
4476,37,Daman and Diu,240556,212882,27674,2021-07-06 18:01:44
4477,1,Andaman and Nicobar Islands,202865,162373,40492,2021-07-07 18:02:20
4478,2,Andhra Pradesh,16676789,13322285,3354504,2021-07-07 18:02:20
4479,3,Arunachal Pradesh,667128,565823,101305,2021-07-07 18:02:20
4480,4,Assam,7720505,6402476,1318029,2021-07-07 18:02:20
4481,5,Bihar,17610100,15113068,2497032,2021-07-07 18:02:20
4482,6,Chandigarh,580735,476076,104659,2021-07-07 18:02:20
4483,7,Chhattisgarh,9065399,7321544,1743855,2021-07-07 18:02:20
4484,8,Dadra and Nagar Haveli,256333,230342,25991,2021-07-07 18:02:20
4485,9,Delhi,8520756,6554851,1965905,2021-07-07 18:02:20
4486,10,Goa,1036104,889028,147076,2021-07-07 18:02:20
4487,11,Gujarat,27340027,21186487,6153540,2021-07-07 18:02:20
4488,12,Haryana,9617391,7967878,1649513,2021-07-07 18:02:20
4489,13,Himachal Pradesh,4173028,3406867,766161,2021-07-07 18:02:20
4490,14,Jammu and Kashmir,5003671,4209146,794525,2021-07-07 18:02:20
4491,15,Jharkhand,7515450,6276757,1238693,2021-07-07 18:02:20
4492,16,Karnataka,24739154,20354749,4384405,2021-07-07 18:02:20
4493,17,Kerala,15120585,11356275,3764310,2021-07-07 18:02:20
4494,18,Ladakh,238305,178128,60177,2021-07-07 18:02:20
4495,19,Lakshadweep,57324,47562,9762,2021-07-07 18:02:20
4496,20,Madhya Pradesh,22486768,18987978,3498790,2021-07-07 18:02:20
4497,21,Maharashtra,35444489,28046480,7398009,2021-07-07 18:02:20
4498,22,Manipur,816460,735358,81102,2021-07-07 18:02:20
4499,23,Meghalaya,775205,684309,90896,2021-07-07 18:02:20
4500,24,Mizoram,632113,562364,69749,2021-07-07 18:02:20
4501,25,Nagaland,564970,486470,78500,2021-07-07 18:02:20
4502,26,Odisha,13129991,10541012,2588979,2021-07-07 18:02:20
4503,27,Puducherry,558068,467894,90174,2021-07-07 18:02:20
4504,28,Punjab,7290636,5977846,1312790,2021-07-07 18:02:20
4505,29,Rajasthan,25937520,21492586,4444934,2021-07-07 18:02:20
4506,30,Sikkim,537467,432987,104480,2021-07-07 18:02:20
4507,31,Tamil Nadu,17093526,14279592,2813934,2021-07-07 18:02:20
4508,32,Telangana,11992695,10182849,1809846,2021-07-07 18:02:20
4509,33,Tripura,2648571,2022188,626383,2021-07-07 18:02:20
4510,34,Uttar Pradesh,35267463,29892445,5375018,2021-07-07 18:02:20
4511,35,Uttarakhand,4801508,3843884,957624,2021-07-07 18:02:20
4512,36,West Bengal,23366652,17454711,5911941,2021-07-07 18:02:20
4513,37,Daman and Diu,242494,213878,28616,2021-07-07 18:02:20
4514,1,Andaman and Nicobar Islands,208594,163284,45310,2021-07-08 18:11:17
4515,2,Andhra Pradesh,16715911,13347419,3368492,2021-07-08 18:11:17
4516,3,Arunachal Pradesh,679561,574598,104963,2021-07-08 18:11:17
4517,4,Assam,7730301,6409336,1320965,2021-07-08 18:11:17
4518,5,Bihar,18063158,15479479,2583679,2021-07-08 18:11:17
4519,6,Chandigarh,586654,479535,107119,2021-07-08 18:11:17
4520,7,Chhattisgarh,9152127,7374760,1777367,2021-07-08 18:11:17
4521,8,Dadra and Nagar Haveli,262596,235954,26642,2021-07-08 18:11:17
4522,9,Delhi,8679752,6666282,2013470,2021-07-08 18:11:17
4523,10,Goa,1047488,896123,151365,2021-07-08 18:11:17
4524,11,Gujarat,27347053,21189977,6157076,2021-07-08 18:11:17
4525,12,Haryana,9658310,7991006,1667304,2021-07-08 18:11:17
4526,13,Himachal Pradesh,4220136,3414079,806057,2021-07-08 18:11:17
4527,14,Jammu and Kashmir,5063909,4253650,810259,2021-07-08 18:11:17
4528,15,Jharkhand,7549569,6301519,1248050,2021-07-08 18:11:17
4529,16,Karnataka,24941814,20494591,4447223,2021-07-08 18:11:17
4530,17,Kerala,15221414,11393122,3828292,2021-07-08 18:11:17
4531,18,Ladakh,239589,179174,60415,2021-07-08 18:11:17
4532,19,Lakshadweep,57844,47717,10127,2021-07-08 18:11:17
4533,20,Madhya Pradesh,23209424,19540483,3668941,2021-07-08 18:11:17
4534,21,Maharashtra,35772811,28250166,7522645,2021-07-08 18:11:17
4535,22,Manipur,841124,758837,82287,2021-07-08 18:11:17
4536,23,Meghalaya,789963,696143,93820,2021-07-08 18:11:17
4537,24,Mizoram,649616,572405,77211,2021-07-08 18:11:17
4538,25,Nagaland,575372,492720,82652,2021-07-08 18:11:17
4539,26,Odisha,13275073,10623119,2651954,2021-07-08 18:11:17
4540,27,Puducherry,566525,470882,95643,2021-07-08 18:11:17
4541,28,Punjab,7317865,5994518,1323347,2021-07-08 18:11:17
4542,29,Rajasthan,26122903,21575079,4547824,2021-07-08 18:11:17
4543,30,Sikkim,546775,436734,110041,2021-07-08 18:11:17
4544,31,Tamil Nadu,17242667,14363188,2879479,2021-07-08 18:11:17
4545,32,Telangana,12106184,10249542,1856642,2021-07-08 18:11:17
4546,33,Tripura,2662612,2031459,631153,2021-07-08 18:11:17
4547,34,Uttar Pradesh,36067913,30535594,5532319,2021-07-08 18:11:17
4548,35,Uttarakhand,4836289,3865405,970884,2021-07-08 18:11:17
4549,36,West Bengal,23612813,17550438,6062375,2021-07-08 18:11:17
4550,37,Daman and Diu,244468,214981,29487,2021-07-08 18:11:17
4551,1,Andaman and Nicobar Islands,215725,164079,51646,2021-07-09 18:01:41
4552,2,Andhra Pradesh,16752650,13372990,3379660,2021-07-09 18:01:41
4553,3,Arunachal Pradesh,691414,583021,108393,2021-07-09 18:01:41
4554,4,Assam,7790895,6462249,1328646,2021-07-09 18:01:41
4555,5,Bihar,18380464,15741778,2638686,2021-07-09 18:01:41
4556,6,Chandigarh,594496,483886,110610,2021-07-09 18:01:41
4557,7,Chhattisgarh,9258662,7438953,1819709,2021-07-09 18:01:41
4558,8,Dadra and Nagar Haveli,269649,242023,27626,2021-07-09 18:01:41
4559,9,Delhi,8810952,6761634,2049318,2021-07-09 18:01:41
4560,10,Goa,1063046,904928,158118,2021-07-09 18:01:41
4561,11,Gujarat,27353299,21193413,6159886,2021-07-09 18:01:41
4562,12,Haryana,9768115,8055066,1713049,2021-07-09 18:01:41
4563,13,Himachal Pradesh,4258863,3419934,838929,2021-07-09 18:01:41
4564,14,Jammu and Kashmir,5088504,4271861,816643,2021-07-09 18:01:41
4565,15,Jharkhand,7573202,6318405,1254797,2021-07-09 18:01:41
4566,16,Karnataka,25276633,20709063,4567570,2021-07-09 18:01:41
4567,17,Kerala,15412596,11454395,3958201,2021-07-09 18:01:41
4568,18,Ladakh,240818,180257,60561,2021-07-09 18:01:41
4569,19,Lakshadweep,58285,47830,10455,2021-07-09 18:01:41
4570,20,Madhya Pradesh,23229284,19555644,3673640,2021-07-09 18:01:41
4571,21,Maharashtra,35975179,28386677,7588502,2021-07-09 18:01:41
4572,22,Manipur,854304,770529,83775,2021-07-09 18:01:41
4573,23,Meghalaya,801829,705803,96026,2021-07-09 18:01:41
4574,24,Mizoram,667224,580502,86722,2021-07-09 18:01:41
4575,25,Nagaland,586955,500263,86692,2021-07-09 18:01:41
4576,26,Odisha,13376305,10682934,2693371,2021-07-09 18:01:41
4577,27,Puducherry,574935,473954,100981,2021-07-09 18:01:41
4578,28,Punjab,7331991,6002896,1329095,2021-07-09 18:01:41
4579,29,Rajasthan,26199280,21609462,4589818,2021-07-09 18:01:41
4580,30,Sikkim,556100,440417,115683,2021-07-09 18:01:41
4581,31,Tamil Nadu,17335483,14417332,2918151,2021-07-09 18:01:41
4582,32,Telangana,12272850,10353167,1919683,2021-07-09 18:01:41
4583,33,Tripura,2681121,2043269,637852,2021-07-09 18:01:41
4584,34,Uttar Pradesh,36814185,31124499,5689686,2021-07-09 18:01:41
4585,35,Uttarakhand,4864248,3882032,982216,2021-07-09 18:01:41
4586,36,West Bengal,23853229,17633240,6219989,2021-07-09 18:01:41
4587,37,Daman and Diu,246282,216034,30248,2021-07-09 18:01:41
4588,1,Andaman and Nicobar Islands,222583,166096,56487,2021-07-10 18:15:39
4589,2,Andhra Pradesh,16945717,13472620,3473097,2021-07-10 18:15:39
4590,3,Arunachal Pradesh,701667,590002,111665,2021-07-10 18:15:39
4591,4,Assam,7910876,6565772,1345104,2021-07-10 18:15:39
4592,5,Bihar,18555157,15881330,2673827,2021-07-10 18:15:39
4593,6,Chandigarh,605255,490212,115043,2021-07-10 18:15:39
4594,7,Chhattisgarh,9331192,7492006,1839186,2021-07-10 18:15:39
4595,8,Dadra and Nagar Haveli,277619,249145,28474,2021-07-10 18:15:39
4596,9,Delhi,8890766,6814195,2076571,2021-07-10 18:15:39
4597,10,Goa,1083489,917304,166185,2021-07-10 18:15:39
4598,11,Gujarat,27637054,21372920,6264134,2021-07-10 18:15:39
4599,12,Haryana,9848083,8104736,1743347,2021-07-10 18:15:39
4600,13,Himachal Pradesh,4281031,3423175,857856,2021-07-10 18:15:39
4601,14,Jammu and Kashmir,5114832,4293518,821314,2021-07-10 18:15:39
4602,15,Jharkhand,7649649,6368144,1281505,2021-07-10 18:15:39
4603,16,Karnataka,25518726,20854108,4664618,2021-07-10 18:15:39
4604,17,Kerala,15667228,11544597,4122631,2021-07-10 18:15:39
4605,18,Ladakh,242115,181385,60730,2021-07-10 18:15:39
4606,19,Lakshadweep,58606,47936,10670,2021-07-10 18:15:39
4607,20,Madhya Pradesh,23916986,20128154,3788832,2021-07-10 18:15:39
4608,21,Maharashtra,36344221,28600239,7743982,2021-07-10 18:15:39
4609,22,Manipur,861136,776522,84614,2021-07-10 18:15:39
4610,23,Meghalaya,809993,712488,97505,2021-07-10 18:15:39
4611,24,Mizoram,671369,583307,88062,2021-07-10 18:15:39
4612,25,Nagaland,589915,502157,87758,2021-07-10 18:15:39
4613,26,Odisha,13443455,10726646,2716809,2021-07-10 18:15:39
4614,27,Puducherry,586989,479916,107073,2021-07-10 18:15:39
4615,28,Punjab,7387130,6045372,1341758,2021-07-10 18:15:39
4616,29,Rajasthan,26331376,21664006,4667370,2021-07-10 18:15:39
4617,30,Sikkim,560587,442125,118462,2021-07-10 18:15:39
4618,31,Tamil Nadu,17404688,14464514,2940174,2021-07-10 18:15:39
4619,32,Telangana,12395170,10417596,1977574,2021-07-10 18:15:39
4620,33,Tripura,2705451,2058009,647442,2021-07-10 18:15:39
4621,34,Uttar Pradesh,37165499,31368297,5797202,2021-07-10 18:15:39
4622,35,Uttarakhand,4889320,3899297,990023,2021-07-10 18:15:39
4623,36,West Bengal,24068021,17705150,6362871,2021-07-10 18:15:39
4624,37,Daman and Diu,248446,217152,31294,2021-07-10 18:15:39
4625,1,Andaman and Nicobar Islands,223059,166343,56716,2021-07-11 18:07:50
4626,2,Andhra Pradesh,17054306,13530165,3524141,2021-07-11 18:07:50
4627,3,Arunachal Pradesh,706004,593330,112674,2021-07-11 18:07:50
4628,4,Assam,8015929,6663892,1352037,2021-07-11 18:07:50
4629,5,Bihar,18592326,15907215,2685111,2021-07-11 18:07:50
4630,6,Chandigarh,611733,494636,117097,2021-07-11 18:07:50
4631,7,Chhattisgarh,9350244,7506260,1843984,2021-07-11 18:07:50
4632,8,Dadra and Nagar Haveli,280533,251628,28905,2021-07-11 18:07:50
4633,9,Delhi,8901626,6821204,2080422,2021-07-11 18:07:50
4634,10,Goa,1096064,925096,170968,2021-07-11 18:07:50
4635,11,Gujarat,27866090,21524473,6341617,2021-07-11 18:07:50
4636,12,Haryana,9878706,8123738,1754968,2021-07-11 18:07:50
4637,13,Himachal Pradesh,4281308,3423246,858062,2021-07-11 18:07:50
4638,14,Jammu and Kashmir,5149835,4314400,835435,2021-07-11 18:07:50
4639,15,Jharkhand,7674657,6385917,1288740,2021-07-11 18:07:50
4640,16,Karnataka,25624609,20921104,4703505,2021-07-11 18:07:50
4641,17,Kerala,15700974,11559011,4141963,2021-07-11 18:07:50
4642,18,Ladakh,242545,181815,60730,2021-07-11 18:07:50
4643,19,Lakshadweep,58734,47993,10741,2021-07-11 18:07:50
4644,20,Madhya Pradesh,23934917,20143867,3791050,2021-07-11 18:07:50
4645,21,Maharashtra,36525862,28703462,7822400,2021-07-11 18:07:50
4646,22,Manipur,865889,781122,84767,2021-07-11 18:07:50
4647,23,Meghalaya,810573,712955,97618,2021-07-11 18:07:50
4648,24,Mizoram,671701,583639,88062,2021-07-11 18:07:50
4649,25,Nagaland,594317,505475,88842,2021-07-11 18:07:50
4650,26,Odisha,13451477,10732651,2718826,2021-07-11 18:07:50
4651,27,Puducherry,594602,484522,110080,2021-07-11 18:07:50
4652,28,Punjab,7415803,6070212,1345591,2021-07-11 18:07:50
4653,29,Rajasthan,26410483,21723913,4686570,2021-07-11 18:07:50
4654,30,Sikkim,560587,442125,118462,2021-07-11 18:07:50
4655,31,Tamil Nadu,17489838,14521299,2968539,2021-07-11 18:07:50
4656,32,Telangana,12409905,10422316,1987589,2021-07-11 18:07:50
4657,33,Tripura,2708867,2060295,648572,2021-07-11 18:07:50
4658,34,Uttar Pradesh,37182190,31380936,5801254,2021-07-11 18:07:50
4659,35,Uttarakhand,4907160,3913957,993203,2021-07-11 18:07:50
4660,36,West Bengal,24157577,17733441,6424136,2021-07-11 18:07:50
4661,37,Daman and Diu,248747,217317,31430,2021-07-11 18:07:50
4662,1,Andaman and Nicobar Islands,230450,168328,62122,2021-07-12 18:02:09
4663,2,Andhra Pradesh,17357400,13680228,3677172,2021-07-12 18:02:09
4664,3,Arunachal Pradesh,717072,600139,116933,2021-07-12 18:02:09
4665,4,Assam,8264288,6895245,1369043,2021-07-12 18:02:09
4666,5,Bihar,18943852,16191133,2752719,2021-07-12 18:02:09
4667,6,Chandigarh,620721,500328,120393,2021-07-12 18:02:09
4668,7,Chhattisgarh,9371010,7521061,1849949,2021-07-12 18:02:09
4669,8,Dadra and Nagar Haveli,286921,257483,29438,2021-07-12 18:02:09
4670,9,Delhi,8937940,6843441,2094499,2021-07-12 18:02:09
4671,10,Goa,1113775,935694,178081,2021-07-12 18:02:09
4672,11,Gujarat,28122889,21694463,6428426,2021-07-12 18:02:09
4673,12,Haryana,9930266,8153273,1776993,2021-07-12 18:02:09
4674,13,Himachal Pradesh,4319288,3427554,891734,2021-07-12 18:02:09
4675,14,Jammu and Kashmir,5196038,4339069,856969,2021-07-12 18:02:09
4676,15,Jharkhand,7694498,6400833,1293665,2021-07-12 18:02:09
4677,16,Karnataka,25882198,21086849,4795349,2021-07-12 18:02:09
4678,17,Kerala,15911270,11633723,4277547,2021-07-12 18:02:09
4679,18,Ladakh,243556,182438,61118,2021-07-12 18:02:09
4680,19,Lakshadweep,59081,48058,11023,2021-07-12 18:02:09
4681,20,Madhya Pradesh,23973478,20157496,3815982,2021-07-12 18:02:09
4682,21,Maharashtra,37024077,28982004,8042073,2021-07-12 18:02:09
4683,22,Manipur,880377,794059,86318,2021-07-12 18:02:09
4684,23,Meghalaya,824300,723817,100483,2021-07-12 18:02:09
4685,24,Mizoram,685007,588460,96547,2021-07-12 18:02:09
4686,25,Nagaland,606945,512320,94625,2021-07-12 18:02:09
4687,26,Odisha,13502341,10773343,2728998,2021-07-12 18:02:09
4688,27,Puducherry,610205,493582,116623,2021-07-12 18:02:09
4689,28,Punjab,7618925,6190246,1428679,2021-07-12 18:02:09
4690,29,Rajasthan,26449059,21746599,4702460,2021-07-12 18:02:09
4691,30,Sikkim,570245,445999,124246,2021-07-12 18:02:09
4692,31,Tamil Nadu,17843953,14777773,3066180,2021-07-12 18:02:09
4693,32,Telangana,12589998,10533342,2056656,2021-07-12 18:02:09
4694,33,Tripura,2733684,2074654,659030,2021-07-12 18:02:09
4695,34,Uttar Pradesh,37697118,31757700,5939418,2021-07-12 18:02:09
4696,35,Uttarakhand,4931083,3930208,1000875,2021-07-12 18:02:09
4697,36,West Bengal,24356550,17798311,6558239,2021-07-12 18:02:09
4698,37,Daman and Diu,250704,218563,32141,2021-07-12 18:02:09
4699,1,Andaman and Nicobar Islands,236645,170392,66253,2021-07-13 18:16:03
4700,2,Andhra Pradesh,17589477,13817568,3771909,2021-07-13 18:16:03
4701,3,Arunachal Pradesh,726070,605243,120827,2021-07-13 18:16:03
4702,4,Assam,8346086,6961897,1384189,2021-07-13 18:16:03
4703,5,Bihar,19094504,16313606,2780898,2021-07-13 18:16:03
4704,6,Chandigarh,628577,505214,123363,2021-07-13 18:16:03
4705,7,Chhattisgarh,9381749,7528635,1853114,2021-07-13 18:16:03
4706,8,Dadra and Nagar Haveli,293418,263513,29905,2021-07-13 18:16:03
4707,9,Delhi,9067022,6936013,2131009,2021-07-13 18:16:03
4708,10,Goa,1127686,943067,184619,2021-07-13 18:16:03
4709,11,Gujarat,28376312,21860758,6515554,2021-07-13 18:16:03
4710,12,Haryana,10063614,8228952,1834662,2021-07-13 18:16:03
4711,13,Himachal Pradesh,4361944,3433064,928880,2021-07-13 18:16:03
4712,14,Jammu and Kashmir,5223791,4354531,869260,2021-07-13 18:16:03
4713,15,Jharkhand,7827456,6479490,1347966,2021-07-13 18:16:03
4714,16,Karnataka,26042614,21196915,4845699,2021-07-13 18:16:03
4715,17,Kerala,16059858,11695199,4364659,2021-07-13 18:16:03
4716,18,Ladakh,244282,182773,61509,2021-07-13 18:16:03
4717,19,Lakshadweep,59657,48155,11502,2021-07-13 18:16:03
4718,20,Madhya Pradesh,23977911,20160054,3817857,2021-07-13 18:16:03
4719,21,Maharashtra,37296249,29129845,8166404,2021-07-13 18:16:03
4720,22,Manipur,911582,821525,90057,2021-07-13 18:16:03
4721,23,Meghalaya,839967,736070,103897,2021-07-13 18:16:03
4722,24,Mizoram,695980,592691,103289,2021-07-13 18:16:03
4723,25,Nagaland,618772,519353,99419,2021-07-13 18:16:03
4724,26,Odisha,13577304,10830287,2747017,2021-07-13 18:16:03
4725,27,Puducherry,615861,496806,119055,2021-07-13 18:16:03
4726,28,Punjab,7664312,6217365,1446947,2021-07-13 18:16:03
4727,29,Rajasthan,26864455,21932046,4932409,2021-07-13 18:16:03
4728,30,Sikkim,572209,447174,125035,2021-07-13 18:16:03
4729,31,Tamil Nadu,18181398,15039119,3142279,2021-07-13 18:16:03
4730,32,Telangana,12746415,10626050,2120365,2021-07-13 18:16:03
4731,33,Tripura,2755529,2088117,667412,2021-07-13 18:16:03
4732,34,Uttar Pradesh,38345389,32262219,6083170,2021-07-13 18:16:03
4733,35,Uttarakhand,4960171,3938366,1021805,2021-07-13 18:16:03
4734,36,West Bengal,24586285,17895909,6690376,2021-07-13 18:16:03
4735,37,Daman and Diu,252088,219390,32698,2021-07-13 18:16:03
4736,1,Andaman and Nicobar Islands,246669,177013,69656,2021-07-14 18:11:14
4737,2,Andhra Pradesh,18040090,14191112,3848978,2021-07-14 18:11:14
4738,3,Arunachal Pradesh,736247,611763,124484,2021-07-14 18:11:14
4739,4,Assam,8474492,7042260,1432232,2021-07-14 18:11:14
4740,5,Bihar,19302470,16477106,2825364,2021-07-14 18:11:14
4741,6,Chandigarh,646643,520502,126141,2021-07-14 18:11:14
4742,7,Chhattisgarh,9630813,7744106,1886707,2021-07-14 18:11:14
4743,8,Dadra and Nagar Haveli,301334,271003,30331,2021-07-14 18:11:14
4744,9,Delhi,9153718,7002464,2151254,2021-07-14 18:11:14
4745,10,Goa,1144976,954703,190273,2021-07-14 18:11:14
4746,11,Gujarat,28503866,21984688,6519178,2021-07-14 18:11:14
4747,12,Haryana,10187224,8323935,1863289,2021-07-14 18:11:14
4748,13,Himachal Pradesh,4447275,3491953,955322,2021-07-14 18:11:14
4749,14,Jammu and Kashmir,5287631,4411788,875843,2021-07-14 18:11:14
4750,15,Jharkhand,7969071,6584629,1384442,2021-07-14 18:11:14
4751,16,Karnataka,26484472,21531193,4953279,2021-07-14 18:11:14
4752,17,Kerala,16206261,11787878,4418383,2021-07-14 18:11:14
4753,18,Ladakh,246067,184350,61717,2021-07-14 18:11:14
4754,19,Lakshadweep,60568,48684,11884,2021-07-14 18:11:14
4755,20,Madhya Pradesh,24566317,20652966,3913351,2021-07-14 18:11:14
4756,21,Maharashtra,37924042,29557531,8366511,2021-07-14 18:11:14
4757,22,Manipur,946944,852445,94499,2021-07-14 18:11:14
4758,23,Meghalaya,853459,746519,106940,2021-07-14 18:11:14
4759,24,Mizoram,709269,600309,108960,2021-07-14 18:11:14
4760,25,Nagaland,633282,528576,104706,2021-07-14 18:11:14
4761,26,Odisha,13815672,10994545,2821127,2021-07-14 18:11:14
4762,27,Puducherry,628690,506999,121691,2021-07-14 18:11:14
4763,28,Punjab,7797266,6339924,1457342,2021-07-14 18:11:14
4764,29,Rajasthan,27443343,22338369,5104974,2021-07-14 18:11:14
4765,30,Sikkim,576624,451037,125587,2021-07-14 18:11:14
4766,31,Tamil Nadu,18548239,15322521,3225718,2021-07-14 18:11:14
4767,32,Telangana,12840921,10707196,2133725,2021-07-14 18:11:14
4768,33,Tripura,2782404,2109378,673026,2021-07-14 18:11:14
4769,34,Uttar Pradesh,38837428,32665993,6171435,2021-07-14 18:11:14
4770,35,Uttarakhand,5024419,3968209,1056210,2021-07-14 18:11:14
4771,36,West Bengal,25034355,18136147,6898208,2021-07-14 18:11:14
4772,37,Daman and Diu,255580,222220,33360,2021-07-14 18:11:14
4773,1,Andaman and Nicobar Islands,251147,178771,72376,2021-07-15 18:13:05
4774,2,Andhra Pradesh,18130140,14242409,3887731,2021-07-15 18:13:05
4775,3,Arunachal Pradesh,746764,617766,128998,2021-07-15 18:13:05
4776,4,Assam,8543611,7073403,1470208,2021-07-15 18:13:05
4777,5,Bihar,19783157,16847635,2935522,2021-07-15 18:13:05
4778,6,Chandigarh,655179,525981,129198,2021-07-15 18:13:05
4779,7,Chhattisgarh,9676220,7769158,1907062,2021-07-15 18:13:05
4780,8,Dadra and Nagar Haveli,306956,276252,30704,2021-07-15 18:13:05
4781,9,Delhi,9186905,7023654,2163251,2021-07-15 18:13:05
4782,10,Goa,1155882,960479,195403,2021-07-15 18:13:05
4783,11,Gujarat,28762393,22155836,6606557,2021-07-15 18:13:05
4784,12,Haryana,10258746,8367171,1891575,2021-07-15 18:13:05
4785,13,Himachal Pradesh,4473681,3495554,978127,2021-07-15 18:13:05
4786,14,Jammu and Kashmir,5363634,4452507,911127,2021-07-15 18:13:05
4787,15,Jharkhand,8018791,6620137,1398654,2021-07-15 18:13:05
4788,16,Karnataka,26614219,21609700,5004519,2021-07-15 18:13:05
4789,17,Kerala,16360256,11856125,4504131,2021-07-15 18:13:05
4790,18,Ladakh,246543,184640,61903,2021-07-15 18:13:05
4791,19,Lakshadweep,61144,48780,12364,2021-07-15 18:13:05
4792,20,Madhya Pradesh,25015501,21028776,3986725,2021-07-15 18:13:05
4793,21,Maharashtra,38267995,29723209,8544786,2021-07-15 18:13:05
4794,22,Manipur,974479,876836,97643,2021-07-15 18:13:05
4795,23,Meghalaya,870101,758555,111546,2021-07-15 18:13:05
4796,24,Mizoram,721084,604815,116269,2021-07-15 18:13:05
4797,25,Nagaland,643785,534668,109117,2021-07-15 18:13:05
4798,26,Odisha,14014960,11090865,2924095,2021-07-15 18:13:05
4799,27,Puducherry,633987,510271,123716,2021-07-15 18:13:05
4800,28,Punjab,7822491,6358671,1463820,2021-07-15 18:13:05
4801,29,Rajasthan,27500600,22373497,5127103,2021-07-15 18:13:05
4802,30,Sikkim,586083,455475,130608,2021-07-15 18:13:05
4803,31,Tamil Nadu,18730668,15443587,3287081,2021-07-15 18:13:05
4804,32,Telangana,12962575,10762037,2200538,2021-07-15 18:13:05
4805,33,Tripura,2808453,2126035,682418,2021-07-15 18:13:05
4806,34,Uttar Pradesh,39516462,33208981,6307481,2021-07-15 18:13:05
4807,35,Uttarakhand,5092396,3992311,1100085,2021-07-15 18:13:05
4808,36,West Bengal,25273258,18247452,7025806,2021-07-15 18:13:05
4809,37,Daman and Diu,256684,222873,33811,2021-07-15 18:13:05
4810,1,Andaman and Nicobar Islands,254814,179879,74935,2021-07-16 18:13:05
4811,2,Andhra Pradesh,18391785,14395270,3996515,2021-07-16 18:13:05
4812,3,Arunachal Pradesh,756314,623036,133278,2021-07-16 18:13:05
4813,4,Assam,8643029,7145077,1497952,2021-07-16 18:13:05
4814,5,Bihar,20092154,17088089,3004065,2021-07-16 18:13:05
4815,6,Chandigarh,664346,531740,132606,2021-07-16 18:13:05
4816,7,Chhattisgarh,9691397,7778039,1913358,2021-07-16 18:13:05
4817,8,Dadra and Nagar Haveli,313187,282129,31058,2021-07-16 18:13:05
4818,9,Delhi,9274314,7086069,2188245,2021-07-16 18:13:05
4819,10,Goa,1166709,965882,200827,2021-07-16 18:13:05
4820,11,Gujarat,29037045,22342001,6695044,2021-07-16 18:13:05
4821,12,Haryana,10412492,8456784,1955708,2021-07-16 18:13:05
4822,13,Himachal Pradesh,4500778,3498848,1001930,2021-07-16 18:13:05
4823,14,Jammu and Kashmir,5437313,4489337,947976,2021-07-16 18:13:05
4824,15,Jharkhand,8186347,6726458,1459889,2021-07-16 18:13:05
4825,16,Karnataka,26851134,21741826,5109308,2021-07-16 18:13:05
4826,17,Kerala,16485990,11918604,4567386,2021-07-16 18:13:05
4827,18,Ladakh,246776,184757,62019,2021-07-16 18:13:05
4828,19,Lakshadweep,61637,48893,12744,2021-07-16 18:13:05
4829,20,Madhya Pradesh,25028056,21039211,3988845,2021-07-16 18:13:05
4830,21,Maharashtra,38894689,30053289,8841400,2021-07-16 18:13:05
4831,22,Manipur,1001544,901371,100173,2021-07-16 18:13:05
4832,23,Meghalaya,886290,769669,116621,2021-07-16 18:13:05
4833,24,Mizoram,733598,608456,125142,2021-07-16 18:13:05
4834,25,Nagaland,653588,541764,111824,2021-07-16 18:13:05
4835,26,Odisha,14143588,11146869,2996719,2021-07-16 18:13:05
4836,27,Puducherry,639723,513820,125903,2021-07-16 18:13:05
4837,28,Punjab,8002865,6465498,1537367,2021-07-16 18:13:05
4838,29,Rajasthan,27641745,22426875,5214870,2021-07-16 18:13:05
4839,30,Sikkim,595976,461643,134333,2021-07-16 18:13:05
4840,31,Tamil Nadu,19028978,15655125,3373853,2021-07-16 18:13:05
4841,32,Telangana,13148507,10833368,2315139,2021-07-16 18:13:05
4842,33,Tripura,2827700,2137737,689963,2021-07-16 18:13:05
4843,34,Uttar Pradesh,39934673,33522527,6412146,2021-07-16 18:13:05
4844,35,Uttarakhand,5145220,4014316,1130904,2021-07-16 18:13:05
4845,36,West Bengal,25609415,18379397,7230018,2021-07-16 18:13:05
4846,37,Daman and Diu,257988,223621,34367,2021-07-16 18:13:05
4847,1,Andaman and Nicobar Islands,257871,180673,77198,2021-07-17 18:01:39
4848,2,Andhra Pradesh,18625728,14507747,4117981,2021-07-17 18:01:39
4849,3,Arunachal Pradesh,763807,627353,136454,2021-07-17 18:01:39
4850,4,Assam,8763717,7237044,1526673,2021-07-17 18:01:39
4851,5,Bihar,20663069,17553230,3109839,2021-07-17 18:01:39
4852,6,Chandigarh,676154,538909,137245,2021-07-17 18:01:39
4853,7,Chhattisgarh,9876604,7889111,1987493,2021-07-17 18:01:39
4854,8,Dadra and Nagar Haveli,317705,286243,31462,2021-07-17 18:01:39
4855,9,Delhi,9346116,7134416,2211700,2021-07-17 18:01:39
4856,10,Goa,1184432,975773,208659,2021-07-17 18:01:39
4857,11,Gujarat,29350855,22562358,6788497,2021-07-17 18:01:39
4858,12,Haryana,10509222,8514017,1995205,2021-07-17 18:01:39
4859,13,Himachal Pradesh,4544791,3505004,1039787,2021-07-17 18:01:39
4860,14,Jammu and Kashmir,5482249,4512931,969318,2021-07-17 18:01:39
4861,15,Jharkhand,8278886,6794892,1483994,2021-07-17 18:01:39
4862,16,Karnataka,27211216,21951177,5260039,2021-07-17 18:01:39
4863,17,Kerala,16650485,11989687,4660798,2021-07-17 18:01:39
4864,18,Ladakh,247139,184970,62169,2021-07-17 18:01:39
4865,19,Lakshadweep,61956,48946,13010,2021-07-17 18:01:39
4866,20,Madhya Pradesh,25182121,21168157,4013964,2021-07-17 18:01:39
4867,21,Maharashtra,39381845,30339078,9042767,2021-07-17 18:01:39
4868,22,Manipur,1027069,923052,104017,2021-07-17 18:01:39
4869,23,Meghalaya,897149,777402,119747,2021-07-17 18:01:39
4870,24,Mizoram,736794,609286,127508,2021-07-17 18:01:39
4871,25,Nagaland,657850,545012,112838,2021-07-17 18:01:39
4872,26,Odisha,14261550,11189648,3071902,2021-07-17 18:01:39
4873,27,Puducherry,645742,517902,127840,2021-07-17 18:01:39
4874,28,Punjab,8035894,6485454,1550440,2021-07-17 18:01:39
4875,29,Rajasthan,28339982,22825332,5514650,2021-07-17 18:01:39
4876,30,Sikkim,600482,464383,136099,2021-07-17 18:01:39
4877,31,Tamil Nadu,19382285,15924709,3457576,2021-07-17 18:01:39
4878,32,Telangana,13267645,10868291,2399354,2021-07-17 18:01:39
4879,33,Tripura,2832538,2140335,692203,2021-07-17 18:01:39
4880,34,Uttar Pradesh,40351449,33830125,6521324,2021-07-17 18:01:39
4881,35,Uttarakhand,5201427,4035902,1165525,2021-07-17 18:01:39
4882,36,West Bengal,26000121,18540516,7459605,2021-07-17 18:01:39
4883,37,Daman and Diu,259703,224610,35093,2021-07-17 18:01:39
4884,1,Andaman and Nicobar Islands,258110,180805,77305,2021-07-18 18:16:06
4885,2,Andhra Pradesh,18649051,14513706,4135345,2021-07-18 18:16:06
4886,3,Arunachal Pradesh,767031,629663,137368,2021-07-18 18:16:06
4887,4,Assam,8782510,7250332,1532178,2021-07-18 18:16:06
4888,5,Bihar,20914922,17761503,3153419,2021-07-18 18:16:06
4889,6,Chandigarh,684417,544177,140240,2021-07-18 18:16:06
4890,7,Chhattisgarh,9951458,7939192,2012266,2021-07-18 18:16:06
4891,8,Dadra and Nagar Haveli,318485,286932,31553,2021-07-18 18:16:06
4892,9,Delhi,9357476,7141467,2216009,2021-07-18 18:16:06
4893,10,Goa,1190638,978988,211650,2021-07-18 18:16:06
4894,11,Gujarat,29354675,22564829,6789846,2021-07-18 18:16:06
4895,12,Haryana,10578419,8558860,2019559,2021-07-18 18:16:06
4896,13,Himachal Pradesh,4544883,3505080,1039803,2021-07-18 18:16:06
4897,14,Jammu and Kashmir,5534891,4544050,990841,2021-07-18 18:16:06
4898,15,Jharkhand,8316876,6824102,1492774,2021-07-18 18:16:06
4899,16,Karnataka,27324330,22018801,5305529,2021-07-18 18:16:06
4900,17,Kerala,16704293,12021046,4683247,2021-07-18 18:16:06
4901,18,Ladakh,247199,185017,62182,2021-07-18 18:16:06
4902,19,Lakshadweep,62021,49004,13017,2021-07-18 18:16:06
4903,20,Madhya Pradesh,25192158,21176794,4015364,2021-07-18 18:16:06
4904,21,Maharashtra,39513058,30417030,9096028,2021-07-18 18:16:06
4905,22,Manipur,1033928,929481,104447,2021-07-18 18:16:06
4906,23,Meghalaya,897621,777736,119885,2021-07-18 18:16:06
4907,24,Mizoram,736894,609380,127514,2021-07-18 18:16:06
4908,25,Nagaland,665218,550447,114771,2021-07-18 18:16:06
4909,26,Odisha,14275865,11197418,3078447,2021-07-18 18:16:06
4910,27,Puducherry,647196,519005,128191,2021-07-18 18:16:06
4911,28,Punjab,8041864,6488932,1552932,2021-07-18 18:16:06
4912,29,Rajasthan,28728054,23104088,5623966,2021-07-18 18:16:06
4913,30,Sikkim,600616,464508,136108,2021-07-18 18:16:06
4914,31,Tamil Nadu,19496996,16014013,3482983,2021-07-18 18:16:06
4915,32,Telangana,13280389,10872534,2407855,2021-07-18 18:16:06
4916,33,Tripura,2833900,2141163,692737,2021-07-18 18:16:06
4917,34,Uttar Pradesh,40368178,33842280,6525898,2021-07-18 18:16:06
4918,35,Uttarakhand,5230315,4052712,1177603,2021-07-18 18:16:06
4919,36,West Bengal,26098053,18590094,7507959,2021-07-18 18:16:06
4920,37,Daman and Diu,259981,224709,35272,2021-07-18 18:16:06
4921,1,Andaman and Nicobar Islands,261259,181725,79534,2021-07-19 18:15:50
4922,2,Andhra Pradesh,18797967,14559126,4238841,2021-07-19 18:15:50
4923,3,Arunachal Pradesh,776986,635185,141801,2021-07-19 18:15:50
4924,4,Assam,8939320,7382171,1557149,2021-07-19 18:15:50
4925,5,Bihar,21339603,18112947,3226656,2021-07-19 18:15:50
4926,6,Chandigarh,693228,549385,143843,2021-07-19 18:15:50
4927,7,Chhattisgarh,10109053,8041911,2067142,2021-07-19 18:15:50
4928,8,Dadra and Nagar Haveli,321254,289437,31817,2021-07-19 18:15:50
4929,9,Delhi,9383467,7158176,2225291,2021-07-19 18:15:50
4930,10,Goa,1202589,985642,216947,2021-07-19 18:15:50
4931,11,Gujarat,29751152,22849133,6902019,2021-07-19 18:15:50
4932,12,Haryana,10696109,8633271,2062838,2021-07-19 18:15:50
4933,13,Himachal Pradesh,4607739,3542306,1065433,2021-07-19 18:15:50
4934,14,Jammu and Kashmir,5622199,4585652,1036547,2021-07-19 18:15:50
4935,15,Jharkhand,8349211,6848768,1500443,2021-07-19 18:15:50
4936,16,Karnataka,27595996,22187924,5408072,2021-07-19 18:15:50
4937,17,Kerala,17058684,12156815,4901869,2021-07-19 18:15:50
4938,18,Ladakh,247527,185146,62381,2021-07-19 18:15:50
4939,19,Lakshadweep,62346,49064,13282,2021-07-19 18:15:50
4940,20,Madhya Pradesh,25678516,21551160,4127356,2021-07-19 18:15:50
4941,21,Maharashtra,39911420,30636226,9275194,2021-07-19 18:15:50
4942,22,Manipur,1057386,946997,110389,2021-07-19 18:15:50
4943,23,Meghalaya,914978,788233,126745,2021-07-19 18:15:50
4944,24,Mizoram,752265,614347,137918,2021-07-19 18:15:50
4945,25,Nagaland,679321,560636,118685,2021-07-19 18:15:50
4946,26,Odisha,14571472,11329406,3242066,2021-07-19 18:15:50
4947,27,Puducherry,654259,523930,130329,2021-07-19 18:15:50
4948,28,Punjab,8055801,6497157,1558644,2021-07-19 18:15:50
4949,29,Rajasthan,29004440,23295064,5709376,2021-07-19 18:15:50
4950,30,Sikkim,602701,465924,136777,2021-07-19 18:15:50
4951,31,Tamil Nadu,19749085,16212301,3536784,2021-07-19 18:15:50
4952,32,Telangana,13453988,10941162,2512826,2021-07-19 18:15:50
4953,33,Tripura,2855785,2153655,702130,2021-07-19 18:15:50
4954,34,Uttar Pradesh,41047998,34390799,6657199,2021-07-19 18:15:50
4955,35,Uttarakhand,5298863,4088662,1210201,2021-07-19 18:15:50
4956,36,West Bengal,26425090,18750894,7674196,2021-07-19 18:15:50
4957,37,Daman and Diu,261076,225343,35733,2021-07-19 18:15:50
4958,1,Andaman and Nicobar Islands,265699,184157,81542,2021-07-20 18:01:42
4959,2,Andhra Pradesh,19036238,14668281,4367957,2021-07-20 18:01:42
4960,3,Arunachal Pradesh,783786,638759,145027,2021-07-20 18:01:42
4961,4,Assam,9084754,7497592,1587162,2021-07-20 18:01:42
4962,5,Bihar,21518602,18257434,3261168,2021-07-20 18:01:42
4963,6,Chandigarh,703489,554918,148571,2021-07-20 18:01:42
4964,7,Chhattisgarh,10244935,8135158,2109777,2021-07-20 18:01:42
4965,8,Dadra and Nagar Haveli,324092,291981,32111,2021-07-20 18:01:42
4966,9,Delhi,9455470,7200320,2255150,2021-07-20 18:01:42
4967,10,Goa,1213360,990912,222448,2021-07-20 18:01:42
4968,11,Gujarat,30164637,23145112,7019525,2021-07-20 18:01:42
4969,12,Haryana,10792955,8692323,2100632,2021-07-20 18:01:42
4970,13,Himachal Pradesh,4683571,3593645,1089926,2021-07-20 18:01:42
4971,14,Jammu and Kashmir,5676697,4615137,1061560,2021-07-20 18:01:42
4972,15,Jharkhand,8370920,6864386,1506534,2021-07-20 18:01:42
4973,16,Karnataka,27779600,22304712,5474888,2021-07-20 18:01:42
4974,17,Kerala,17329394,12277830,5051564,2021-07-20 18:01:42
4975,18,Ladakh,247824,185298,62526,2021-07-20 18:01:42
4976,19,Lakshadweep,62715,49196,13519,2021-07-20 18:01:42
4977,20,Madhya Pradesh,25692342,21562031,4130311,2021-07-20 18:01:42
4978,21,Maharashtra,40107948,30751876,9356072,2021-07-20 18:01:42
4979,22,Manipur,1082124,965549,116575,2021-07-20 18:01:42
4980,23,Meghalaya,933601,799336,134265,2021-07-20 18:01:42
4981,24,Mizoram,768748,619529,149219,2021-07-20 18:01:42
4982,25,Nagaland,692524,569978,122546,2021-07-20 18:01:42
4983,26,Odisha,14789563,11441234,3348329,2021-07-20 18:01:42
4984,27,Puducherry,660092,528009,132083,2021-07-20 18:01:42
4985,28,Punjab,8066359,6503408,1562951,2021-07-20 18:01:42
4986,29,Rajasthan,29112114,23366886,5745228,2021-07-20 18:01:42
4987,30,Sikkim,610184,471162,139022,2021-07-20 18:01:42
4988,31,Tamil Nadu,19919524,16351116,3568408,2021-07-20 18:01:42
4989,32,Telangana,13502037,10956059,2545978,2021-07-20 18:01:42
4990,33,Tripura,2874151,2163480,710671,2021-07-20 18:01:42
4991,34,Uttar Pradesh,41559223,34794693,6764530,2021-07-20 18:01:42
4992,35,Uttarakhand,5373777,4132892,1240885,2021-07-20 18:01:42
4993,36,West Bengal,26685478,18892232,7793246,2021-07-20 18:01:42
4994,37,Daman and Diu,262299,226057,36242,2021-07-20 18:01:42
4995,1,Andaman and Nicobar Islands,265754,184160,81594,2021-07-21 18:11:10
4996,2,Andhra Pradesh,19154817,14739379,4415438,2021-07-21 18:11:10
4997,3,Arunachal Pradesh,791295,642710,148585,2021-07-21 18:11:10
4998,4,Assam,9128219,7532329,1595890,2021-07-21 18:11:10
4999,5,Bihar,21549709,18282135,3267574,2021-07-21 18:11:10
5000,6,Chandigarh,711040,558850,152190,2021-07-21 18:11:10
5001,7,Chhattisgarh,10291464,8170833,2120631,2021-07-21 18:11:10
5002,8,Dadra and Nagar Haveli,326069,293738,32331,2021-07-21 18:11:10
5003,9,Delhi,9518884,7230289,2288595,2021-07-21 18:11:10
5004,10,Goa,1221997,994834,227163,2021-07-21 18:11:10
5005,11,Gujarat,30174789,23152218,7022571,2021-07-21 18:11:10
5006,12,Haryana,10827853,8709605,2118248,2021-07-21 18:11:10
5007,13,Himachal Pradesh,4684058,3594024,1090034,2021-07-21 18:11:10
5008,14,Jammu and Kashmir,5687736,4622017,1065719,2021-07-21 18:11:10
5009,15,Jharkhand,8469011,6932338,1536673,2021-07-21 18:11:10
5010,16,Karnataka,27957510,22399536,5557974,2021-07-21 18:11:10
5011,17,Kerala,17427952,12340361,5087591,2021-07-21 18:11:10
5012,18,Ladakh,247824,185298,62526,2021-07-21 18:11:10
5013,19,Lakshadweep,62989,49276,13713,2021-07-21 18:11:10
5014,20,Madhya Pradesh,25695476,21563261,4132215,2021-07-21 18:11:10
5015,21,Maharashtra,40217450,30819326,9398124,2021-07-21 18:11:10
5016,22,Manipur,1102219,979839,122380,2021-07-21 18:11:10
5017,23,Meghalaya,948045,807162,140883,2021-07-21 18:11:10
5018,24,Mizoram,773865,621289,152576,2021-07-21 18:11:10
5019,25,Nagaland,704472,577392,127080,2021-07-21 18:11:10
5020,26,Odisha,14920471,11512354,3408117,2021-07-21 18:11:10
5021,27,Puducherry,662515,529753,132762,2021-07-21 18:11:10
5022,28,Punjab,8261290,6615594,1645696,2021-07-21 18:11:10
5023,29,Rajasthan,29445345,23537218,5908127,2021-07-21 18:11:10
5024,30,Sikkim,615158,474356,140802,2021-07-21 18:11:10
5025,31,Tamil Nadu,20093881,16489572,3604309,2021-07-21 18:11:10
5026,32,Telangana,13517322,10961026,2556296,2021-07-21 18:11:10
5027,33,Tripura,2878597,2165745,712852,2021-07-21 18:11:10
5028,34,Uttar Pradesh,42034554,35196571,6837983,2021-07-21 18:11:10
5029,35,Uttarakhand,5405942,4150600,1255342,2021-07-21 18:11:10
5030,36,West Bengal,26778393,18951477,7826916,2021-07-21 18:11:10
5031,37,Daman and Diu,263069,226446,36623,2021-07-21 18:11:10
5032,1,Andaman and Nicobar Islands,270664,187006,83658,2021-07-22 18:16:00
5033,2,Andhra Pradesh,19324817,14818721,4506096,2021-07-22 18:16:00
5034,3,Arunachal Pradesh,798628,646129,152499,2021-07-22 18:16:00
5035,4,Assam,9337930,7696780,1641150,2021-07-22 18:16:00
5036,5,Bihar,21652372,18344999,3307373,2021-07-22 18:16:00
5037,6,Chandigarh,720736,563735,157001,2021-07-22 18:16:00
5038,7,Chhattisgarh,10341831,8207768,2134063,2021-07-22 18:16:00
5039,8,Dadra and Nagar Haveli,328988,296369,32619,2021-07-22 18:16:00
5040,9,Delhi,9567507,7252529,2314978,2021-07-22 18:16:00
5041,10,Goa,1232518,999900,232618,2021-07-22 18:16:00
5042,11,Gujarat,30682161,23508914,7173247,2021-07-22 18:16:00
5043,12,Haryana,10897886,8744222,2153664,2021-07-22 18:16:00
5044,13,Himachal Pradesh,4762348,3645454,1116894,2021-07-22 18:16:00
5045,14,Jammu and Kashmir,5698733,4628601,1070132,2021-07-22 18:16:00
5046,15,Jharkhand,8539989,6980511,1559478,2021-07-22 18:16:00
5047,16,Karnataka,28247972,22570497,5677475,2021-07-22 18:16:00
5048,17,Kerala,17709317,12464564,5244753,2021-07-22 18:16:00
5049,18,Ladakh,248319,185475,62844,2021-07-22 18:16:00
5050,19,Lakshadweep,63093,49304,13789,2021-07-22 18:16:00
5051,20,Madhya Pradesh,26791031,22431445,4359586,2021-07-22 18:16:00
5052,21,Maharashtra,40420907,30922026,9498881,2021-07-22 18:16:00
5053,22,Manipur,1126653,995279,131374,2021-07-22 18:16:00
5054,23,Meghalaya,967622,817913,149709,2021-07-22 18:16:00
5055,24,Mizoram,786131,624169,161962,2021-07-22 18:16:00
5056,25,Nagaland,714870,583739,131131,2021-07-22 18:16:00
5057,26,Odisha,15102699,11611338,3491361,2021-07-22 18:16:00
5058,27,Puducherry,667591,533073,134518,2021-07-22 18:16:00
5059,28,Punjab,8322119,6647300,1674819,2021-07-22 18:16:00
5060,29,Rajasthan,29921633,23791131,6130502,2021-07-22 18:16:00
5061,30,Sikkim,619709,477661,142048,2021-07-22 18:16:00
5062,31,Tamil Nadu,20398939,16739547,3659392,2021-07-22 18:16:00
5063,32,Telangana,13699633,11025806,2673827,2021-07-22 18:16:00
5064,33,Tripura,2899319,2177099,722220,2021-07-22 18:16:00
5065,34,Uttar Pradesh,42792380,35830969,6961411,2021-07-22 18:16:00
5066,35,Uttarakhand,5448544,4169098,1279446,2021-07-22 18:16:00
5067,36,West Bengal,26997115,19069566,7927549,2021-07-22 18:16:00
5068,37,Daman and Diu,264134,227026,37108,2021-07-22 18:16:00
5069,1,Andaman and Nicobar Islands,275377,190151,85226,2021-07-23 18:10:19
5070,2,Andhra Pradesh,19473515,14871831,4601684,2021-07-23 18:10:19
5071,3,Arunachal Pradesh,806642,649997,156645,2021-07-23 18:10:19
5072,4,Assam,9533765,7850458,1683307,2021-07-23 18:10:19
5073,5,Bihar,21715582,18385807,3329775,2021-07-23 18:10:19
5074,6,Chandigarh,731391,569452,161939,2021-07-23 18:10:19
5075,7,Chhattisgarh,10375583,8232424,2143159,2021-07-23 18:10:19
5076,8,Dadra and Nagar Haveli,331950,299014,32936,2021-07-23 18:10:19
5077,9,Delhi,9603697,7268264,2335433,2021-07-23 18:10:19
5078,10,Goa,1243867,1005102,238765,2021-07-23 18:10:19
5079,11,Gujarat,31024303,23751722,7272581,2021-07-23 18:10:19
5080,12,Haryana,10941640,8769732,2171908,2021-07-23 18:10:19
5081,13,Himachal Pradesh,4841256,3697711,1143545,2021-07-23 18:10:19
5082,14,Jammu and Kashmir,5734546,4645667,1088879,2021-07-23 18:10:19
5083,15,Jharkhand,8577086,7008230,1568856,2021-07-23 18:10:19
5084,16,Karnataka,28558855,22755810,5803045,2021-07-23 18:10:19
5085,17,Kerala,17976287,12585905,5390382,2021-07-23 18:10:19
5086,18,Ladakh,248685,185654,63031,2021-07-23 18:10:19
5087,19,Lakshadweep,63558,49479,14079,2021-07-23 18:10:19
5088,20,Madhya Pradesh,26859236,22489547,4369689,2021-07-23 18:10:19
5089,21,Maharashtra,40855519,31159841,9695678,2021-07-23 18:10:19
5090,22,Manipur,1155874,1010771,145103,2021-07-23 18:10:19
5091,23,Meghalaya,987072,828240,158832,2021-07-23 18:10:19
5092,24,Mizoram,796808,626366,170442,2021-07-23 18:10:19
5093,25,Nagaland,724280,589807,134473,2021-07-23 18:10:19
5094,26,Odisha,15244333,11694484,3549849,2021-07-23 18:10:19
5095,27,Puducherry,674602,538189,136413,2021-07-23 18:10:19
5096,28,Punjab,8345882,6659008,1686874,2021-07-23 18:10:19
5097,29,Rajasthan,30117597,23882904,6234693,2021-07-23 18:10:19
5098,30,Sikkim,624999,481112,143887,2021-07-23 18:10:19
5099,31,Tamil Nadu,20724967,17001787,3723180,2021-07-23 18:10:19
5100,32,Telangana,13843213,11038921,2804292,2021-07-23 18:10:19
5101,33,Tripura,2921426,2190299,731127,2021-07-23 18:10:19
5102,34,Uttar Pradesh,43807386,36704592,7102794,2021-07-23 18:10:19
5103,35,Uttarakhand,5498462,4195409,1303053,2021-07-23 18:10:19
5104,36,West Bengal,27340804,19261651,8079153,2021-07-23 18:10:19
5105,37,Daman and Diu,265253,227621,37632,2021-07-23 18:10:19
5106,1,Andaman and Nicobar Islands,279195,192718,86477,2021-07-24 18:11:15
5107,2,Andhra Pradesh,19565589,14910329,4655260,2021-07-24 18:11:15
5108,3,Arunachal Pradesh,812464,653324,159140,2021-07-24 18:11:15
5109,4,Assam,9669301,7957718,1711583,2021-07-24 18:11:15
5110,5,Bihar,22055218,18652095,3403123,2021-07-24 18:11:15
5111,6,Chandigarh,745126,576913,168213,2021-07-24 18:11:15
5112,7,Chhattisgarh,10417072,8262459,2154613,2021-07-24 18:11:15
5113,8,Dadra and Nagar Haveli,335014,301746,33268,2021-07-24 18:11:15
5114,9,Delhi,9673601,7289525,2384076,2021-07-24 18:11:15
5115,10,Goa,1258741,1013223,245518,2021-07-24 18:11:15
5116,11,Gujarat,31316732,23953275,7363457,2021-07-24 18:11:15
5117,12,Haryana,10982631,8795354,2187277,2021-07-24 18:11:15
5118,13,Himachal Pradesh,4907673,3740883,1166790,2021-07-24 18:11:15
5119,14,Jammu and Kashmir,5820526,4687048,1133478,2021-07-24 18:11:15
5120,15,Jharkhand,8728808,7120261,1608547,2021-07-24 18:11:15
5121,16,Karnataka,28787936,22885641,5902295,2021-07-24 18:11:15
5122,17,Kerala,18464206,12877004,5587202,2021-07-24 18:11:15
5123,18,Ladakh,249041,185770,63271,2021-07-24 18:11:15
5124,19,Lakshadweep,64080,49638,14442,2021-07-24 18:11:15
5125,20,Madhya Pradesh,27835437,23287139,4548298,2021-07-24 18:11:15
5126,21,Maharashtra,41200346,31356540,9843806,2021-07-24 18:11:15
5127,22,Manipur,1186488,1029246,157242,2021-07-24 18:11:15
5128,23,Meghalaya,1000322,836068,164254,2021-07-24 18:11:15
5129,24,Mizoram,798104,626561,171543,2021-07-24 18:11:15
5130,25,Nagaland,727512,592238,135274,2021-07-24 18:11:15
5131,26,Odisha,15394878,11786884,3607994,2021-07-24 18:11:15
5132,27,Puducherry,684227,545647,138580,2021-07-24 18:11:15
5133,28,Punjab,8469949,6719588,1750361,2021-07-24 18:11:15
5134,29,Rajasthan,30199259,23920844,6278415,2021-07-24 18:11:15
5135,30,Sikkim,626545,482041,144504,2021-07-24 18:11:15
5136,31,Tamil Nadu,21027753,17244484,3783269,2021-07-24 18:11:15
5137,32,Telangana,14010811,11070089,2940722,2021-07-24 18:11:15
5138,33,Tripura,2951600,2209808,741792,2021-07-24 18:11:15
5139,34,Uttar Pradesh,44388727,37179632,7209095,2021-07-24 18:11:15
5140,35,Uttarakhand,5526721,4210352,1316369,2021-07-24 18:11:15
5141,36,West Bengal,27681733,19487241,8194492,2021-07-24 18:11:15
5142,37,Daman and Diu,266564,228480,38084,2021-07-24 18:11:15
5143,1,Andaman and Nicobar Islands,279839,193281,86558,2021-07-25 18:10:36
5144,2,Andhra Pradesh,19570886,14913421,4657465,2021-07-25 18:10:36
5145,3,Arunachal Pradesh,815005,655107,159898,2021-07-25 18:10:36
5146,4,Assam,9733328,8008339,1724989,2021-07-25 18:10:36
5147,5,Bihar,22521082,19020216,3500866,2021-07-25 18:10:36
5148,6,Chandigarh,752626,581613,171013,2021-07-25 18:10:36
5149,7,Chhattisgarh,10486913,8308316,2178597,2021-07-25 18:10:36
5150,8,Dadra and Nagar Haveli,335945,302580,33365,2021-07-25 18:10:36
5151,9,Delhi,9684216,7296521,2387695,2021-07-25 18:10:36
5152,10,Goa,1265385,1016953,248432,2021-07-25 18:10:36
5153,11,Gujarat,31639048,24207744,7431304,2021-07-25 18:10:36
5154,12,Haryana,11021435,8818842,2202593,2021-07-25 18:10:36
5155,13,Himachal Pradesh,4907764,3740953,1166811,2021-07-25 18:10:36
5156,14,Jammu and Kashmir,5861643,4711124,1150519,2021-07-25 18:10:36
5157,15,Jharkhand,8884178,7241246,1642932,2021-07-25 18:10:36
5158,16,Karnataka,28886583,22942185,5944398,2021-07-25 18:10:36
5159,17,Kerala,18594259,12972001,5622258,2021-07-25 18:10:36
5160,18,Ladakh,249041,185770,63271,2021-07-25 18:10:36
5161,19,Lakshadweep,64116,49661,14455,2021-07-25 18:10:36
5162,20,Madhya Pradesh,27868363,23316206,4552157,2021-07-25 18:10:36
5163,21,Maharashtra,41318461,31424845,9893616,2021-07-25 18:10:36
5164,22,Manipur,1197316,1038690,158626,2021-07-25 18:10:36
5165,23,Meghalaya,1000685,836298,164387,2021-07-25 18:10:36
5166,24,Mizoram,798300,626660,171640,2021-07-25 18:10:36
5167,25,Nagaland,730846,594445,136401,2021-07-25 18:10:36
5168,26,Odisha,15417257,11803367,3613890,2021-07-25 18:10:36
5169,27,Puducherry,685245,546427,138818,2021-07-25 18:10:36
5170,28,Punjab,8494820,6731924,1762896,2021-07-25 18:10:36
5171,29,Rajasthan,30375699,23957890,6417809,2021-07-25 18:10:36
5172,30,Sikkim,626545,482041,144504,2021-07-25 18:10:36
5173,31,Tamil Nadu,21134839,17331126,3803713,2021-07-25 18:10:36
5174,32,Telangana,14020071,11074061,2946010,2021-07-25 18:10:36
5175,33,Tripura,2972645,2226413,746232,2021-07-25 18:10:36
5176,34,Uttar Pradesh,44412722,37199136,7213586,2021-07-25 18:10:36
5177,35,Uttarakhand,5537425,4213887,1323538,2021-07-25 18:10:36
5178,36,West Bengal,27759330,19549132,8210198,2021-07-25 18:10:36
5179,37,Daman and Diu,266670,228516,38154,2021-07-25 18:10:36
5180,1,Andaman and Nicobar Islands,282966,195082,87884,2021-07-26 18:13:51
5181,2,Andhra Pradesh,20753512,15733829,5019683,2021-07-26 18:13:51
5182,3,Arunachal Pradesh,822087,658962,163125,2021-07-26 18:13:51
5183,4,Assam,9983825,8201982,1781843,2021-07-26 18:13:51
5184,5,Bihar,22873038,19299851,3573187,2021-07-26 18:13:51
5185,6,Chandigarh,761995,587081,174914,2021-07-26 18:13:51
5186,7,Chhattisgarh,10562418,8363088,2199330,2021-07-26 18:13:51
5187,8,Dadra and Nagar Haveli,338946,305352,33594,2021-07-26 18:13:51
5188,9,Delhi,9741598,7311091,2430507,2021-07-26 18:13:51
5189,10,Goa,1276977,1023636,253341,2021-07-26 18:13:51
5190,11,Gujarat,31813064,24295191,7517873,2021-07-26 18:13:51
5191,12,Haryana,11125623,8880653,2244970,2021-07-26 18:13:51
5192,13,Himachal Pradesh,4965278,3779130,1186148,2021-07-26 18:13:51
5193,14,Jammu and Kashmir,5921876,4741621,1180255,2021-07-26 18:13:51
5194,15,Jharkhand,9026731,7351176,1675555,2021-07-26 18:13:51
5195,16,Karnataka,29125539,23073939,6051600,2021-07-26 18:13:51
5196,17,Kerala,18811780,13128347,5683433,2021-07-26 18:13:51
5197,18,Ladakh,249727,186038,63689,2021-07-26 18:13:51
5198,19,Lakshadweep,64502,49794,14708,2021-07-26 18:13:51
5199,20,Madhya Pradesh,29006804,24275999,4730805,2021-07-26 18:13:51
5200,21,Maharashtra,41768947,31668541,10100406,2021-07-26 18:13:51
5201,22,Manipur,1225903,1055427,170476,2021-07-26 18:13:51
5202,23,Meghalaya,1018011,846481,171530,2021-07-26 18:13:51
5203,24,Mizoram,803772,628506,175266,2021-07-26 18:13:51
5204,25,Nagaland,739944,599958,139986,2021-07-26 18:13:51
5205,26,Odisha,15617944,11939137,3678807,2021-07-26 18:13:51
5206,27,Puducherry,690732,550512,140220,2021-07-26 18:13:51
5207,28,Punjab,8523555,6747639,1775916,2021-07-26 18:13:51
5208,29,Rajasthan,30600816,24030759,6570057,2021-07-26 18:13:51
5209,30,Sikkim,630016,484753,145263,2021-07-26 18:13:51
5210,31,Tamil Nadu,21430837,17578231,3852606,2021-07-26 18:13:51
5211,32,Telangana,14167136,11107971,3059165,2021-07-26 18:13:51
5212,33,Tripura,2999864,2245548,754316,2021-07-26 18:13:51
5213,34,Uttar Pradesh,45228929,37893326,7335603,2021-07-26 18:13:51
5214,35,Uttarakhand,5573723,4229473,1344250,2021-07-26 18:13:51
5215,36,West Bengal,28065385,19762581,8302804,2021-07-26 18:13:51
5216,37,Daman and Diu,267680,229139,38541,2021-07-26 18:13:51
5217,1,Andaman and Nicobar Islands,286856,197991,88865,2021-07-27 18:08:07
5218,2,Andhra Pradesh,20928087,15829320,5098767,2021-07-27 18:08:07
5219,3,Arunachal Pradesh,826787,661530,165257,2021-07-27 18:08:07
5220,4,Assam,10234256,8393598,1840658,2021-07-27 18:08:07
5221,5,Bihar,23113597,19489196,3624401,2021-07-27 18:08:07
5222,6,Chandigarh,771657,592744,178913,2021-07-27 18:08:07
5223,7,Chhattisgarh,10608626,8395689,2212937,2021-07-27 18:08:07
5224,8,Dadra and Nagar Haveli,342245,308436,33809,2021-07-27 18:08:07
5225,9,Delhi,9779440,7324923,2454517,2021-07-27 18:08:07
5226,10,Goa,1286117,1029078,257039,2021-07-27 18:08:07
5227,11,Gujarat,32188899,24554163,7634736,2021-07-27 18:08:07
5228,12,Haryana,11209983,8927366,2282617,2021-07-27 18:08:07
5229,13,Himachal Pradesh,5020337,3813969,1206368,2021-07-27 18:08:07
5230,14,Jammu and Kashmir,5958646,4762219,1196427,2021-07-27 18:08:07
5231,15,Jharkhand,9135518,7436916,1698602,2021-07-27 18:08:07
5232,16,Karnataka,29417347,23244325,6173022,2021-07-27 18:08:07
5233,17,Kerala,18942910,13233990,5708920,2021-07-27 18:08:07
5234,18,Ladakh,250768,186256,64512,2021-07-27 18:08:07
5235,19,Lakshadweep,65060,49949,15111,2021-07-27 18:08:07
5236,20,Madhya Pradesh,29072338,24331336,4741002,2021-07-27 18:08:07
5237,21,Maharashtra,42352271,31989528,10362743,2021-07-27 18:08:07
5238,22,Manipur,1244397,1066474,177923,2021-07-27 18:08:07
5239,23,Meghalaya,1034494,856343,178151,2021-07-27 18:08:07
5240,24,Mizoram,813058,630725,182333,2021-07-27 18:08:07
5241,25,Nagaland,747478,604714,142764,2021-07-27 18:08:07
5242,26,Odisha,15811574,12064903,3746671,2021-07-27 18:08:07
5243,27,Puducherry,694875,553579,141296,2021-07-27 18:08:07
5244,28,Punjab,8542425,6757301,1785124,2021-07-27 18:08:07
5245,29,Rajasthan,30844855,24135690,6709165,2021-07-27 18:08:07
5246,30,Sikkim,632688,486553,146135,2021-07-27 18:08:07
5247,31,Tamil Nadu,21727255,17830930,3896325,2021-07-27 18:08:07
5248,32,Telangana,14274446,11133570,3140876,2021-07-27 18:08:07
5249,33,Tripura,3035040,2272429,762611,2021-07-27 18:08:07
5250,34,Uttar Pradesh,45716508,38286687,7429821,2021-07-27 18:08:07
5251,35,Uttarakhand,5615998,4248420,1367578,2021-07-27 18:08:07
5252,36,West Bengal,28332814,19956751,8376063,2021-07-27 18:08:07
5253,37,Daman and Diu,269024,230164,38860,2021-07-27 18:08:07
5254,1,Andaman and Nicobar Islands,290801,201244,89557,2021-07-29 03:27:31
5255,2,Andhra Pradesh,21025625,15860970,5164655,2021-07-29 03:27:31
5256,3,Arunachal Pradesh,832256,664317,167939,2021-07-29 03:27:31
5257,4,Assam,10341710,8476245,1865465,2021-07-29 03:27:31
5258,5,Bihar,23270179,19604300,3665879,2021-07-29 03:27:31
5259,6,Chandigarh,780708,597901,182807,2021-07-29 03:27:31
5260,7,Chhattisgarh,10647064,8422153,2224911,2021-07-29 03:27:31
5261,8,Dadra and Nagar Haveli,345316,311319,33997,2021-07-29 03:27:31
5262,9,Delhi,9837247,7336542,2500705,2021-07-29 03:27:31
5263,10,Goa,1295529,1034482,261047,2021-07-29 03:27:31
5264,11,Gujarat,32203120,24563776,7639344,2021-07-29 03:27:31
5265,12,Haryana,11355899,9022451,2333448,2021-07-29 03:27:31
5266,13,Himachal Pradesh,5067025,3844633,1222392,2021-07-29 03:27:31
5267,14,Jammu and Kashmir,6033327,4805043,1228284,2021-07-29 03:27:31
5268,15,Jharkhand,9209878,7496161,1713717,2021-07-29 03:27:31
5269,16,Karnataka,29596896,23352332,6244564,2021-07-29 03:27:31
5270,17,Kerala,19009970,13292691,5717279,2021-07-29 03:27:31
5271,18,Ladakh,252103,186477,65626,2021-07-29 03:27:31
5272,19,Lakshadweep,65418,50017,15401,2021-07-29 03:27:31
5273,20,Madhya Pradesh,30150558,25242266,4908292,2021-07-29 03:27:31
5274,21,Maharashtra,42707317,32189240,10518077,2021-07-29 03:27:31
5275,22,Manipur,1267268,1079705,187563,2021-07-29 03:27:31
5276,23,Meghalaya,1047742,864207,183535,2021-07-29 03:27:31
5277,24,Mizoram,821586,633507,188079,2021-07-29 03:27:31
5278,25,Nagaland,753720,608661,145059,2021-07-29 03:27:31
5279,26,Odisha,16002897,12206638,3796259,2021-07-29 03:27:31
5280,27,Puducherry,698810,556500,142310,2021-07-29 03:27:31
5281,28,Punjab,8637626,6806417,1831209,2021-07-29 03:27:31
5282,29,Rajasthan,31308628,24360155,6948473,2021-07-29 03:27:31
5283,30,Sikkim,633927,487514,146413,2021-07-29 03:27:31
5284,31,Tamil Nadu,21985876,18046934,3938942,2021-07-29 03:27:31
5285,32,Telangana,14291866,11140017,3151849,2021-07-29 03:27:31
5286,33,Tripura,3076716,2305601,771115,2021-07-29 03:27:31
5287,34,Uttar Pradesh,46335570,38818090,7517480,2021-07-29 03:27:31
5288,35,Uttarakhand,5648690,4268486,1380204,2021-07-29 03:27:31
5289,36,West Bengal,28597528,20136326,8461202,2021-07-29 03:27:31
5290,37,Daman and Diu,270184,231007,39177,2021-07-29 03:27:31
5291,1,Andaman and Nicobar Islands,294198,203975,90223,2021-07-29 18:14:09
5292,2,Andhra Pradesh,21173255,15906265,5266990,2021-07-29 18:14:09
5293,3,Arunachal Pradesh,836809,666557,170252,2021-07-29 18:14:09
5294,4,Assam,10448906,8560333,1888573,2021-07-29 18:14:09
5295,5,Bihar,23662515,19910198,3752317,2021-07-29 18:14:09
5296,6,Chandigarh,789355,603124,186231,2021-07-29 18:14:09
5297,7,Chhattisgarh,10753709,8494366,2259343,2021-07-29 18:14:09
5298,8,Dadra and Nagar Haveli,348373,314181,34192,2021-07-29 18:14:09
5299,9,Delhi,9909776,7350096,2559680,2021-07-29 18:14:09
5300,10,Goa,1304583,1040080,264503,2021-07-29 18:14:09
5301,11,Gujarat,32635472,24873108,7762364,2021-07-29 18:14:09
5302,12,Haryana,11527918,9129628,2398290,2021-07-29 18:14:09
5303,13,Himachal Pradesh,5096580,3863935,1232645,2021-07-29 18:14:09
5304,14,Jammu and Kashmir,6104697,4843934,1260763,2021-07-29 18:14:09
5305,15,Jharkhand,9367956,7613816,1754140,2021-07-29 18:14:09
5306,16,Karnataka,29725737,23430600,6295137,2021-07-29 18:14:09
5307,17,Kerala,19271174,13465864,5805310,2021-07-29 18:14:09
5308,18,Ladakh,252857,186751,66106,2021-07-29 18:14:09
5309,19,Lakshadweep,65707,50094,15613,2021-07-29 18:14:09
5310,20,Madhya Pradesh,30906116,25904540,5001576,2021-07-29 18:14:09
5311,21,Maharashtra,43082312,32393868,10688444,2021-07-29 18:14:09
5312,22,Manipur,1282382,1088641,193741,2021-07-29 18:14:09
5313,23,Meghalaya,1063158,873724,189434,2021-07-29 18:14:09
5314,24,Mizoram,827813,636054,191759,2021-07-29 18:14:09
5315,25,Nagaland,758573,611482,147091,2021-07-29 18:14:09
5316,26,Odisha,16162194,12330934,3831260,2021-07-29 18:14:09
5317,27,Puducherry,704580,561167,143413,2021-07-29 18:14:09
5318,28,Punjab,8751968,6868957,1883011,2021-07-29 18:14:09
5319,29,Rajasthan,31750352,24540264,7210088,2021-07-29 18:14:09
5320,30,Sikkim,635789,488841,146948,2021-07-29 18:14:09
5321,31,Tamil Nadu,22323375,18307571,4015804,2021-07-29 18:14:09
5322,32,Telangana,14456726,11176326,3280400,2021-07-29 18:14:09
5323,33,Tripura,3102351,2325845,776506,2021-07-29 18:14:09
5324,34,Uttar Pradesh,46779743,39184333,7595410,2021-07-29 18:14:09
5325,35,Uttarakhand,5742959,4346421,1396538,2021-07-29 18:14:09
5326,36,West Bengal,28826431,20302042,8524389,2021-07-29 18:14:09
5327,37,Daman and Diu,271493,232044,39449,2021-07-29 18:14:09
5328,1,Andaman and Nicobar Islands,296896,206031,90865,2021-07-30 18:08:28
5329,2,Andhra Pradesh,21414613,15950840,5463773,2021-07-30 18:08:28
5330,3,Arunachal Pradesh,841615,668946,172669,2021-07-30 18:08:28
5331,4,Assam,10533219,8622219,1911000,2021-07-30 18:08:28
5332,5,Bihar,23969818,20156249,3813569,2021-07-30 18:08:28
5333,6,Chandigarh,798368,608006,190362,2021-07-30 18:08:28
5334,7,Chhattisgarh,10850626,8563013,2287613,2021-07-30 18:08:28
5335,8,Dadra and Nagar Haveli,351355,316970,34385,2021-07-30 18:08:28
5336,9,Delhi,9965538,7363608,2601930,2021-07-30 18:08:28
5337,10,Goa,1314469,1046130,268339,2021-07-30 18:08:28
5338,11,Gujarat,32988155,25138838,7849317,2021-07-30 18:08:28
5339,12,Haryana,11679834,9224499,2455335,2021-07-30 18:08:28
5340,13,Himachal Pradesh,5149148,3898160,1250988,2021-07-30 18:08:28
5341,14,Jammu and Kashmir,6161545,4874004,1287541,2021-07-30 18:08:28
5342,15,Jharkhand,9471180,7689344,1781836,2021-07-30 18:08:28
5343,16,Karnataka,30029134,23623111,6406023,2021-07-30 18:08:28
5344,17,Kerala,19781866,13811980,5969886,2021-07-30 18:08:28
5345,18,Ladakh,253924,186894,67030,2021-07-30 18:08:28
5346,19,Lakshadweep,65988,50168,15820,2021-07-30 18:08:28
5347,20,Madhya Pradesh,30970799,25959893,5010906,2021-07-30 18:08:28
5348,21,Maharashtra,43764145,32792777,10971368,2021-07-30 18:08:28
5349,22,Manipur,1298378,1097943,200435,2021-07-30 18:08:28
5350,23,Meghalaya,1076028,880967,195061,2021-07-30 18:08:28
5351,24,Mizoram,833577,638077,195500,2021-07-30 18:08:28
5352,25,Nagaland,763174,614449,148725,2021-07-30 18:08:28
5353,26,Odisha,16344336,12469151,3875185,2021-07-30 18:08:28
5354,27,Puducherry,710066,565700,144366,2021-07-30 18:08:28
5355,28,Punjab,8893061,6948236,1944825,2021-07-30 18:08:28
5356,29,Rajasthan,32039895,24701914,7337981,2021-07-30 18:08:28
5357,30,Sikkim,637950,490105,147845,2021-07-30 18:08:28
5358,31,Tamil Nadu,22660132,18555545,4104587,2021-07-30 18:08:28
5359,32,Telangana,14585763,11205561,3380202,2021-07-30 18:08:28
5360,33,Tripura,3124359,2343012,781347,2021-07-30 18:08:28
5361,34,Uttar Pradesh,47597459,39901008,7696451,2021-07-30 18:08:28
5362,35,Uttarakhand,5831817,4413409,1418408,2021-07-30 18:08:28
5363,36,West Bengal,29150043,20538959,8611084,2021-07-30 18:08:28
5364,37,Daman and Diu,272977,233187,39790,2021-07-30 18:08:28
5365,1,Andaman and Nicobar Islands,298969,207419,91550,2021-07-31 18:18:55
5366,2,Andhra Pradesh,21669393,16096801,5572592,2021-07-31 18:18:55
5367,3,Arunachal Pradesh,845600,671065,174535,2021-07-31 18:18:55
5368,4,Assam,10638247,8708999,1929248,2021-07-31 18:18:55
5369,5,Bihar,24442464,20551758,3890706,2021-07-31 18:18:55
5370,6,Chandigarh,817144,621982,195162,2021-07-31 18:18:55
5371,7,Chhattisgarh,10953455,8632804,2320651,2021-07-31 18:18:55
5372,8,Dadra and Nagar Haveli,355290,320621,34669,2021-07-31 18:18:55
5373,9,Delhi,10047640,7382742,2664898,2021-07-31 18:18:55
5374,10,Goa,1327101,1054705,272396,2021-07-31 18:18:55
5375,11,Gujarat,33278880,25341390,7937490,2021-07-31 18:18:55
5376,12,Haryana,11824028,9318405,2505623,2021-07-31 18:18:55
5377,13,Himachal Pradesh,5222691,3949268,1273423,2021-07-31 18:18:55
5378,14,Jammu and Kashmir,6215340,4906292,1309048,2021-07-31 18:18:55
5379,15,Jharkhand,9589764,7776741,1813023,2021-07-31 18:18:55
5380,16,Karnataka,30371214,23841981,6529233,2021-07-31 18:18:55
5381,17,Kerala,20165100,14111255,6053845,2021-07-31 18:18:55
5382,18,Ladakh,254727,187081,67646,2021-07-31 18:18:55
5383,19,Lakshadweep,66209,50238,15971,2021-07-31 18:18:55
5384,20,Madhya Pradesh,31999209,26830212,5168997,2021-07-31 18:18:55
5385,21,Maharashtra,44359603,33167633,11191970,2021-07-31 18:18:55
5386,22,Manipur,1313711,1108293,205418,2021-07-31 18:18:55
5387,23,Meghalaya,1086700,888284,198416,2021-07-31 18:18:55
5388,24,Mizoram,835998,639048,196950,2021-07-31 18:18:55
5389,25,Nagaland,765106,615940,149166,2021-07-31 18:18:55
5390,26,Odisha,16499079,12583606,3915473,2021-07-31 18:18:55
5391,27,Puducherry,717225,571733,145492,2021-07-31 18:18:55
5392,28,Punjab,9155481,7192206,1963275,2021-07-31 18:18:55
5393,29,Rajasthan,32468620,24972030,7496590,2021-07-31 18:18:55
5394,30,Sikkim,638736,490631,148105,2021-07-31 18:18:55
5395,31,Tamil Nadu,23036192,18835602,4200590,2021-07-31 18:18:55
5396,32,Telangana,14733008,11249396,3483612,2021-07-31 18:18:55
5397,33,Tripura,3145201,2360019,785182,2021-07-31 18:18:55
5398,34,Uttar Pradesh,48276029,40485878,7790151,2021-07-31 18:18:55
5399,35,Uttarakhand,5906990,4470779,1436211,2021-07-31 18:18:55
5400,36,West Bengal,29518698,20837318,8681380,2021-07-31 18:18:55
5401,37,Daman and Diu,274597,234496,40101,2021-07-31 18:18:55
5402,1,Andaman and Nicobar Islands,301367,209737,91630,2021-08-01 18:01:37
5403,2,Andhra Pradesh,21887210,16301072,5586138,2021-08-01 18:01:37
5404,3,Arunachal Pradesh,847486,672680,174806,2021-08-01 18:01:37
5405,4,Assam,10826140,8877144,1948996,2021-08-01 18:01:37
5406,5,Bihar,24699839,20779993,3919846,2021-08-01 18:01:37
5407,6,Chandigarh,844437,646859,197578,2021-08-01 18:01:37
5408,7,Chhattisgarh,11081805,8748715,2333090,2021-08-01 18:01:37
5409,8,Dadra and Nagar Haveli,357098,322352,34746,2021-08-01 18:01:37
5410,9,Delhi,10104786,7433097,2671689,2021-08-01 18:01:37
5411,10,Goa,1335323,1061058,274265,2021-08-01 18:01:37
5412,11,Gujarat,33738204,25455648,8282556,2021-08-01 18:01:37
5413,12,Haryana,11946622,9408863,2537759,2021-08-01 18:01:37
5414,13,Himachal Pradesh,5242244,3968690,1273554,2021-08-01 18:01:37
5415,14,Jammu and Kashmir,6304714,4980566,1324148,2021-08-01 18:01:37
5416,15,Jharkhand,9718188,7883243,1834945,2021-08-01 18:01:37
5417,16,Karnataka,30664762,24087131,6577631,2021-08-01 18:01:37
5418,17,Kerala,20369496,14284456,6085040,2021-08-01 18:01:37
5419,18,Ladakh,255047,187393,67654,2021-08-01 18:01:37
5420,19,Lakshadweep,66406,50405,16001,2021-08-01 18:01:37
5421,20,Madhya Pradesh,32227488,27049238,5178250,2021-08-01 18:01:37
5422,21,Maharashtra,44671062,33439833,11231229,2021-08-01 18:01:37
5423,22,Manipur,1320730,1114724,206006,2021-08-01 18:01:37
5424,23,Meghalaya,1089428,890971,198457,2021-08-01 18:01:37
5425,24,Mizoram,840956,643917,197039,2021-08-01 18:01:37
5426,25,Nagaland,767610,617873,149737,2021-08-01 18:01:37
5427,26,Odisha,16636971,12717390,3919581,2021-08-01 18:01:37
5428,27,Puducherry,720359,574646,145713,2021-08-01 18:01:37
5429,28,Punjab,9614710,7596875,2017835,2021-08-01 18:01:37
5430,29,Rajasthan,32814367,25283749,7530618,2021-08-01 18:01:37
5431,30,Sikkim,639327,491205,148122,2021-08-01 18:01:37
5432,31,Tamil Nadu,23303574,19063195,4240379,2021-08-01 18:01:37
5433,32,Telangana,14841727,11349272,3492455,2021-08-01 18:01:37
5434,33,Tripura,3164140,2378296,785844,2021-08-01 18:01:37
5435,34,Uttar Pradesh,48442455,40646488,7795967,2021-08-01 18:01:37
5436,35,Uttarakhand,6002377,4557653,1444724,2021-08-01 18:01:37
5437,36,West Bengal,29805755,21101118,8704637,2021-08-01 18:01:37
5438,37,Daman and Diu,275655,235439,40216,2021-08-01 18:01:37
5439,1,Andaman and Nicobar Islands,302726,210578,92148,2021-08-02 18:18:51
5440,2,Andhra Pradesh,22298933,16567700,5731233,2021-08-02 18:18:51
5441,3,Arunachal Pradesh,852548,675931,176617,2021-08-02 18:18:51
5442,4,Assam,11129239,9141787,1987452,2021-08-02 18:18:51
5443,5,Bihar,24886946,20925271,3961675,2021-08-02 18:18:51
5444,6,Chandigarh,852218,651891,200327,2021-08-02 18:18:51
5445,7,Chhattisgarh,11127137,8775131,2352006,2021-08-02 18:18:51
5446,8,Dadra and Nagar Haveli,359574,324675,34899,2021-08-02 18:18:51
5447,9,Delhi,10198712,7482001,2716711,2021-08-02 18:18:51
5448,10,Goa,1343162,1066012,277150,2021-08-02 18:18:51
5449,11,Gujarat,34092852,25735670,8357182,2021-08-02 18:18:51
5450,12,Haryana,12143863,9541597,2602266,2021-08-02 18:18:51
5451,13,Himachal Pradesh,5301613,4010075,1291538,2021-08-02 18:18:51
5452,14,Jammu and Kashmir,6385030,5029174,1355856,2021-08-02 18:18:51
5453,15,Jharkhand,9792734,7935270,1857464,2021-08-02 18:18:51
5454,16,Karnataka,31396158,24583845,6812313,2021-08-02 18:18:51
5455,17,Kerala,20720223,14566582,6153641,2021-08-02 18:18:51
5456,18,Ladakh,255738,187602,68136,2021-08-02 18:18:51
5457,19,Lakshadweep,66642,50484,16158,2021-08-02 18:18:51
5458,20,Madhya Pradesh,33045723,27755842,5289881,2021-08-02 18:18:51
5459,21,Maharashtra,45003338,33649689,11353649,2021-08-02 18:18:51
5460,22,Manipur,1334510,1122259,212251,2021-08-02 18:18:51
5461,23,Meghalaya,1101175,898411,202764,2021-08-02 18:18:51
5462,24,Mizoram,843115,644954,198161,2021-08-02 18:18:51
5463,25,Nagaland,772311,620923,151388,2021-08-02 18:18:51
5464,26,Odisha,16828261,12868643,3959618,2021-08-02 18:18:51
5465,27,Puducherry,724468,577955,146513,2021-08-02 18:18:51
5466,28,Punjab,9691969,7641792,2050177,2021-08-02 18:18:51
5467,29,Rajasthan,33297593,25550176,7747417,2021-08-02 18:18:51
5468,30,Sikkim,642176,493353,148823,2021-08-02 18:18:51
5469,31,Tamil Nadu,23622736,19321702,4301034,2021-08-02 18:18:51
5470,32,Telangana,14960104,11391372,3568732,2021-08-02 18:18:51
5471,33,Tripura,3172471,2383624,788847,2021-08-02 18:18:51
5472,34,Uttar Pradesh,48820310,40954861,7865449,2021-08-02 18:18:51
5473,35,Uttarakhand,6089182,4625366,1463816,2021-08-02 18:18:51
5474,36,West Bengal,30244279,21455703,8788576,2021-08-02 18:18:51
5475,37,Daman and Diu,277387,236919,40468,2021-08-02 18:18:51
5476,1,Andaman and Nicobar Islands,304142,211561,92581,2021-08-03 18:18:57
5477,2,Andhra Pradesh,22476139,16676151,5799988,2021-08-03 18:18:57
5478,3,Arunachal Pradesh,856238,678265,177973,2021-08-03 18:18:57
5479,4,Assam,11429254,9405394,2023860,2021-08-03 18:18:57
5480,5,Bihar,24997957,21000662,3997295,2021-08-03 18:18:57
5481,6,Chandigarh,863331,659902,203429,2021-08-03 18:18:57
5482,7,Chhattisgarh,11181365,8808298,2373067,2021-08-03 18:18:57
5483,8,Dadra and Nagar Haveli,362253,327200,35053,2021-08-03 18:18:57
5484,9,Delhi,10295389,7533335,2762054,2021-08-03 18:18:57
5485,10,Goa,1350317,1070428,279889,2021-08-03 18:18:57
5486,11,Gujarat,34430870,25999229,8431641,2021-08-03 18:18:57
5487,12,Haryana,12319550,9652428,2667122,2021-08-03 18:18:57
5488,13,Himachal Pradesh,5356516,4048893,1307623,2021-08-03 18:18:57
5489,14,Jammu and Kashmir,6450562,5071021,1379541,2021-08-03 18:18:57
5490,15,Jharkhand,9873698,7992103,1881595,2021-08-03 18:18:57
5491,16,Karnataka,31689767,24789310,6900457,2021-08-03 18:18:57
5492,17,Kerala,21008073,14804327,6203746,2021-08-03 18:18:57
5493,18,Ladakh,256201,187750,68451,2021-08-03 18:18:57
5494,19,Lakshadweep,66762,50511,16251,2021-08-03 18:18:57
5495,20,Madhya Pradesh,33169564,27866204,5303360,2021-08-03 18:18:57
5496,21,Maharashtra,45244512,33795497,11449015,2021-08-03 18:18:57
5497,22,Manipur,1345271,1128496,216775,2021-08-03 18:18:57
5498,23,Meghalaya,1113362,906092,207270,2021-08-03 18:18:57
5499,24,Mizoram,844752,645826,198926,2021-08-03 18:18:57
5500,25,Nagaland,776067,623306,152761,2021-08-03 18:18:57
5501,26,Odisha,17054001,13052061,4001940,2021-08-03 18:18:57
5502,27,Puducherry,728541,581231,147310,2021-08-03 18:18:57
5503,28,Punjab,9758467,7683148,2075319,2021-08-03 18:18:57
5504,29,Rajasthan,33624206,25761454,7862752,2021-08-03 18:18:57
5505,30,Sikkim,643576,494089,149487,2021-08-03 18:18:57
5506,31,Tamil Nadu,23903639,19547901,4355738,2021-08-03 18:18:57
5507,32,Telangana,15079216,11437002,3642214,2021-08-03 18:18:57
5508,33,Tripura,3180752,2389080,791672,2021-08-03 18:18:57
5509,34,Uttar Pradesh,51489309,43425457,8063852,2021-08-03 18:18:57
5510,35,Uttarakhand,6165004,4682015,1482989,2021-08-03 18:18:57
5511,36,West Bengal,30676340,21816275,8860065,2021-08-03 18:18:57
5512,37,Daman and Diu,278965,238292,40673,2021-08-03 18:18:57
5513,1,Andaman and Nicobar Islands,305729,212571,93158,2021-08-04 18:18:27
5514,2,Andhra Pradesh,22650260,16786246,5864014,2021-08-04 18:18:27
5515,3,Arunachal Pradesh,860312,680809,179503,2021-08-04 18:18:27
5516,4,Assam,11581397,9535651,2045746,2021-08-04 18:18:27
5517,5,Bihar,25401755,21321757,4079998,2021-08-04 18:18:27
5518,6,Chandigarh,870600,664509,206091,2021-08-04 18:18:27
5519,7,Chhattisgarh,11223885,8829395,2394490,2021-08-04 18:18:27
5520,8,Dadra and Nagar Haveli,364388,329180,35208,2021-08-04 18:18:27
5521,9,Delhi,10381633,7579306,2802327,2021-08-04 18:18:27
5522,10,Goa,1356445,1073972,282473,2021-08-04 18:18:27
5523,11,Gujarat,34445808,26008632,8437176,2021-08-04 18:18:27
5524,12,Haryana,12433360,9721120,2712240,2021-08-04 18:18:27
5525,13,Himachal Pradesh,5405528,4083812,1321716,2021-08-04 18:18:27
5526,14,Jammu and Kashmir,6486798,5094403,1392395,2021-08-04 18:18:27
5527,15,Jharkhand,9938490,8040140,1898350,2021-08-04 18:18:27
5528,16,Karnataka,31957645,24961046,6996599,2021-08-04 18:18:27
5529,17,Kerala,21114463,14882715,6231748,2021-08-04 18:18:27
5530,18,Ladakh,256621,187859,68762,2021-08-04 18:18:27
5531,19,Lakshadweep,67032,50596,16436,2021-08-04 18:18:27
5532,20,Madhya Pradesh,33697618,28297794,5399824,2021-08-04 18:18:27
5533,21,Maharashtra,45474724,33939493,11535231,2021-08-04 18:18:27
5534,22,Manipur,1358157,1135285,222872,2021-08-04 18:18:27
5535,23,Meghalaya,1123660,912022,211638,2021-08-04 18:18:27
5536,24,Mizoram,847086,647051,200035,2021-08-04 18:18:27
5537,25,Nagaland,779573,625565,154008,2021-08-04 18:18:27
5538,26,Odisha,17249912,13208415,4041497,2021-08-04 18:18:27
5539,27,Puducherry,733207,585148,148059,2021-08-04 18:18:27
5540,28,Punjab,9794976,7705110,2089866,2021-08-04 18:18:27
5541,29,Rajasthan,33959663,26005913,7953750,2021-08-04 18:18:27
5542,30,Sikkim,644762,494904,149858,2021-08-04 18:18:27
5543,31,Tamil Nadu,24199269,19760942,4438327,2021-08-04 18:18:27
5544,32,Telangana,15095872,11446097,3649775,2021-08-04 18:18:27
5545,33,Tripura,3186637,2393062,793575,2021-08-04 18:18:27
5546,34,Uttar Pradesh,52140923,43999474,8141449,2021-08-04 18:18:27
5547,35,Uttarakhand,6272010,4768578,1503432,2021-08-04 18:18:27
5548,36,West Bengal,30970620,22061792,8908828,2021-08-04 18:18:27
5549,37,Daman and Diu,280455,239548,40907,2021-08-04 18:18:27
5550,1,Andaman and Nicobar Islands,307014,213457,93557,2021-08-05 18:19:19
5551,2,Andhra Pradesh,22822334,16889200,5933134,2021-08-05 18:19:19
5552,3,Arunachal Pradesh,864439,683244,181195,2021-08-05 18:19:19
5553,4,Assam,11846550,9765007,2081543,2021-08-05 18:19:19
5554,5,Bihar,26174182,21967887,4206295,2021-08-05 18:19:19
5555,6,Chandigarh,878332,669284,209048,2021-08-05 18:19:19
5556,7,Chhattisgarh,11381768,8917133,2464635,2021-08-05 18:19:19
5557,8,Dadra and Nagar Haveli,366946,331471,35475,2021-08-05 18:19:19
5558,9,Delhi,10471779,7630307,2841472,2021-08-05 18:19:19
5559,10,Goa,1362196,1076956,285240,2021-08-05 18:19:19
5560,11,Gujarat,35013810,26465196,8548614,2021-08-05 18:19:19
5561,12,Haryana,12548408,9792908,2755500,2021-08-05 18:19:19
5562,13,Himachal Pradesh,5449747,4115577,1334170,2021-08-05 18:19:19
5563,14,Jammu and Kashmir,6550120,5136611,1413509,2021-08-05 18:19:19
5564,15,Jharkhand,10005289,8089638,1915651,2021-08-05 18:19:19
5565,16,Karnataka,32124981,25060031,7064950,2021-08-05 18:19:19
5566,17,Kerala,21303369,15033777,6269592,2021-08-05 18:19:19
5567,18,Ladakh,257040,188002,69038,2021-08-05 18:19:19
5568,19,Lakshadweep,67253,50668,16585,2021-08-05 18:19:19
5569,20,Madhya Pradesh,34156553,28647319,5509234,2021-08-05 18:19:19
5570,21,Maharashtra,45992850,34253740,11739110,2021-08-05 18:19:19
5571,22,Manipur,1366240,1139436,226804,2021-08-05 18:19:19
5572,23,Meghalaya,1136576,919824,216752,2021-08-05 18:19:19
5573,24,Mizoram,850582,648848,201734,2021-08-05 18:19:19
5574,25,Nagaland,782451,627146,155305,2021-08-05 18:19:19
5575,26,Odisha,17483880,13404289,4079591,2021-08-05 18:19:19
5576,27,Puducherry,737452,588671,148781,2021-08-05 18:19:19
5577,28,Punjab,9827360,7726279,2101081,2021-08-05 18:19:19
5578,29,Rajasthan,34198362,26169393,8028969,2021-08-05 18:19:19
5579,30,Sikkim,646220,495935,150285,2021-08-05 18:19:19
5580,31,Tamil Nadu,24495564,19998737,4496827,2021-08-05 18:19:19
5581,32,Telangana,15237716,11485426,3752290,2021-08-05 18:19:19
5582,33,Tripura,3192345,2396498,795847,2021-08-05 18:19:19
5583,34,Uttar Pradesh,52838552,44597018,8241534,2021-08-05 18:19:19
5584,35,Uttarakhand,6369471,4842044,1527427,2021-08-05 18:19:19
5585,36,West Bengal,31371174,22401043,8970131,2021-08-05 18:19:19
5586,37,Daman and Diu,282033,240786,41247,2021-08-05 18:19:19
5587,1,Andaman and Nicobar Islands,308177,214333,93844,2021-08-06 18:26:30
5588,2,Andhra Pradesh,23390303,17319552,6070751,2021-08-06 18:26:30
5589,3,Arunachal Pradesh,868369,685986,182383,2021-08-06 18:26:30
5590,4,Assam,12087826,9976148,2111678,2021-08-06 18:26:30
5591,5,Bihar,26793524,22499306,4294218,2021-08-06 18:26:30
5592,6,Chandigarh,892796,679894,212902,2021-08-06 18:26:30
5593,7,Chhattisgarh,11593716,9069399,2524317,2021-08-06 18:26:30
5594,8,Dadra and Nagar Haveli,369608,333827,35781,2021-08-06 18:26:30
5595,9,Delhi,10559677,7684071,2875606,2021-08-06 18:26:30
5596,10,Goa,1370190,1081299,288891,2021-08-06 18:26:30
5597,11,Gujarat,35630296,26978214,8652082,2021-08-06 18:26:30
5598,12,Haryana,12654430,9866470,2787960,2021-08-06 18:26:30
5599,13,Himachal Pradesh,5502831,4155025,1347806,2021-08-06 18:26:30
5600,14,Jammu and Kashmir,6603381,5175260,1428121,2021-08-06 18:26:30
5601,15,Jharkhand,10093868,8159603,1934265,2021-08-06 18:26:30
5602,16,Karnataka,32349726,25189842,7159884,2021-08-06 18:26:30
5603,17,Kerala,21560396,15231449,6328947,2021-08-06 18:26:30
5604,18,Ladakh,257551,188226,69325,2021-08-06 18:26:30
5605,19,Lakshadweep,67491,50772,16719,2021-08-06 18:26:30
5606,20,Madhya Pradesh,34238857,28719618,5519239,2021-08-06 18:26:30
5607,21,Maharashtra,46376671,34530607,11846064,2021-08-06 18:26:30
5608,22,Manipur,1379355,1146080,233275,2021-08-06 18:26:30
5609,23,Meghalaya,1149127,927347,221780,2021-08-06 18:26:30
5610,24,Mizoram,855474,651428,204046,2021-08-06 18:26:30
5611,25,Nagaland,785511,629122,156389,2021-08-06 18:26:30
5612,26,Odisha,17713585,13595005,4118580,2021-08-06 18:26:30
5613,27,Puducherry,741807,592246,149561,2021-08-06 18:26:30
5614,28,Punjab,9854254,7743609,2110645,2021-08-06 18:26:30
5615,29,Rajasthan,34620302,26474406,8145896,2021-08-06 18:26:30
5616,30,Sikkim,647540,496921,150619,2021-08-06 18:26:30
5617,31,Tamil Nadu,24818414,20255133,4563281,2021-08-06 18:26:30
5618,32,Telangana,15376994,11548283,3828711,2021-08-06 18:26:30
5619,33,Tripura,3200135,2402094,798041,2021-08-06 18:26:30
5620,34,Uttar Pradesh,53294582,44973804,8320778,2021-08-06 18:26:30
5621,35,Uttarakhand,6424278,4882166,1542112,2021-08-06 18:26:30
5622,36,West Bengal,31774086,22745949,9028137,2021-08-06 18:26:30
5623,37,Daman and Diu,283988,242328,41660,2021-08-06 18:26:30
5624,1,Andaman and Nicobar Islands,309270,215021,94249,2021-08-07 18:19:06
5625,2,Andhra Pradesh,23617219,17477123,6140096,2021-08-07 18:19:06
5626,3,Arunachal Pradesh,871407,688023,183384,2021-08-07 18:19:06
5627,4,Assam,12339414,10189217,2150197,2021-08-07 18:19:06
5628,5,Bihar,27345184,22945519,4399665,2021-08-07 18:19:06
5629,6,Chandigarh,904840,686609,218231,2021-08-07 18:19:06
5630,7,Chhattisgarh,11685860,9123044,2562816,2021-08-07 18:19:06
5631,8,Dadra and Nagar Haveli,373126,336654,36472,2021-08-07 18:19:06
5632,9,Delhi,10679728,7744261,2935467,2021-08-07 18:19:06
5633,10,Goa,1382444,1087385,295059,2021-08-07 18:19:06
5634,11,Gujarat,36211785,27460899,8750886,2021-08-07 18:19:06
5635,12,Haryana,12794804,9952321,2842483,2021-08-07 18:19:06
5636,13,Himachal Pradesh,5551177,4190219,1360958,2021-08-07 18:19:06
5637,14,Jammu and Kashmir,6690063,5234547,1455516,2021-08-07 18:19:06
5638,15,Jharkhand,10218231,8257693,1960538,2021-08-07 18:19:06
5639,16,Karnataka,32764656,25468918,7295738,2021-08-07 18:19:06
5640,17,Kerala,21782429,15416834,6365595,2021-08-07 18:19:06
5641,18,Ladakh,258385,188426,69959,2021-08-07 18:19:06
5642,19,Lakshadweep,67712,50851,16861,2021-08-07 18:19:06
5643,20,Madhya Pradesh,34853048,29211273,5641775,2021-08-07 18:19:06
5644,21,Maharashtra,46685972,34738768,11947204,2021-08-07 18:19:06
5645,22,Manipur,1389342,1150882,238460,2021-08-07 18:19:06
5646,23,Meghalaya,1158718,932413,226305,2021-08-07 18:19:06
5647,24,Mizoram,858266,653314,204952,2021-08-07 18:19:06
5648,25,Nagaland,786795,629818,156977,2021-08-07 18:19:06
5649,26,Odisha,17877357,13727085,4150272,2021-08-07 18:19:06
5650,27,Puducherry,746814,596334,150480,2021-08-07 18:19:06
5651,28,Punjab,10064017,7861095,2202922,2021-08-07 18:19:06
5652,29,Rajasthan,34954868,26710747,8244121,2021-08-07 18:19:06
5653,30,Sikkim,647897,497154,150743,2021-08-07 18:19:06
5654,31,Tamil Nadu,25126156,20507625,4618531,2021-08-07 18:19:06
5655,32,Telangana,15483265,11589487,3893778,2021-08-07 18:19:06
5656,33,Tripura,3205399,2405290,800109,2021-08-07 18:19:06
5657,34,Uttar Pradesh,53589814,45198365,8391449,2021-08-07 18:19:06
5658,35,Uttarakhand,6598224,5023301,1574923,2021-08-07 18:19:06
5659,36,West Bengal,32029325,22959053,9070272,2021-08-07 18:19:06
5660,37,Daman and Diu,286073,243633,42440,2021-08-07 18:19:06
5661,1,Andaman and Nicobar Islands,309349,215077,94272,2021-08-08 18:19:03
5662,2,Andhra Pradesh,23699006,17531461,6167545,2021-08-08 18:19:03
5663,3,Arunachal Pradesh,872897,689266,183631,2021-08-08 18:19:03
5664,4,Assam,12422010,10260435,2161575,2021-08-08 18:19:03
5665,5,Bihar,27628084,23181822,4446262,2021-08-08 18:19:03
5666,6,Chandigarh,911473,690815,220658,2021-08-08 18:19:03
5667,7,Chhattisgarh,11710567,9136504,2574063,2021-08-08 18:19:03
5668,8,Dadra and Nagar Haveli,374620,337715,36905,2021-08-08 18:19:03
5669,9,Delhi,10690855,7750023,2940832,2021-08-08 18:19:03
5670,10,Goa,1387664,1089646,298018,2021-08-08 18:19:03
5671,11,Gujarat,36596532,27636206,8960326,2021-08-08 18:19:03
5672,12,Haryana,12871025,10000236,2870789,2021-08-08 18:19:03
5673,13,Himachal Pradesh,5551548,4190561,1360987,2021-08-08 18:19:03
5674,14,Jammu and Kashmir,6737792,5268567,1469225,2021-08-08 18:19:03
5675,15,Jharkhand,10293046,8315505,1977541,2021-08-08 18:19:03
5676,16,Karnataka,32925156,25590067,7335089,2021-08-08 18:19:03
5677,17,Kerala,21843327,15472524,6370803,2021-08-08 18:19:03
5678,18,Ladakh,258385,188426,69959,2021-08-08 18:19:03
5679,19,Lakshadweep,67913,50962,16951,2021-08-08 18:19:03
5680,20,Madhya Pradesh,34901221,29251571,5649650,2021-08-08 18:19:03
5681,21,Maharashtra,46758590,34789759,11968831,2021-08-08 18:19:03
5682,22,Manipur,1392572,1153469,239103,2021-08-08 18:19:03
5683,23,Meghalaya,1159425,932764,226661,2021-08-08 18:19:03
5684,24,Mizoram,858368,653396,204972,2021-08-08 18:19:03
5685,25,Nagaland,787394,630228,157166,2021-08-08 18:19:03
5686,26,Odisha,17903256,13749311,4153945,2021-08-08 18:19:03
5687,27,Puducherry,748322,597542,150780,2021-08-08 18:19:03
5688,28,Punjab,10140971,7908348,2232623,2021-08-08 18:19:03
5689,29,Rajasthan,35082922,26797208,8285714,2021-08-08 18:19:03
5690,30,Sikkim,647897,497154,150743,2021-08-08 18:19:03
5691,31,Tamil Nadu,25277500,20635755,4641745,2021-08-08 18:19:03
5692,32,Telangana,15494344,11597334,3897010,2021-08-08 18:19:03
5693,33,Tripura,3206922,2406606,800316,2021-08-08 18:19:03
5694,34,Uttar Pradesh,53608615,45211718,8396897,2021-08-08 18:19:03
5695,35,Uttarakhand,6625373,5041919,1583454,2021-08-08 18:19:03
5696,36,West Bengal,32098768,23017864,9080904,2021-08-08 18:19:03
5697,37,Daman and Diu,286240,243646,42594,2021-08-08 18:19:03
5698,1,Andaman and Nicobar Islands,310643,216046,94597,2021-08-09 18:19:12
5699,2,Andhra Pradesh,23842895,17628583,6214312,2021-08-09 18:19:12
5700,3,Arunachal Pradesh,879094,692475,186619,2021-08-09 18:19:12
5701,4,Assam,12703870,10495293,2208577,2021-08-09 18:19:12
5702,5,Bihar,27834939,23350171,4484768,2021-08-09 18:19:12
5703,6,Chandigarh,923819,700285,223534,2021-08-09 18:19:12
5704,7,Chhattisgarh,11769177,9181482,2587695,2021-08-09 18:19:12
5705,8,Dadra and Nagar Haveli,377430,339880,37550,2021-08-09 18:19:12
5706,9,Delhi,10836082,7835546,3000536,2021-08-09 18:19:12
5707,10,Goa,1396911,1094392,302519,2021-08-09 18:19:12
5708,11,Gujarat,37152375,28101222,9051153,2021-08-09 18:19:12
5709,12,Haryana,13010381,10086831,2923550,2021-08-09 18:19:12
5710,13,Himachal Pradesh,5632441,4249849,1382592,2021-08-09 18:19:12
5711,14,Jammu and Kashmir,6808342,5318516,1489826,2021-08-09 18:19:12
5712,15,Jharkhand,10378294,8382280,1996014,2021-08-09 18:19:12
5713,16,Karnataka,33280543,25847691,7432852,2021-08-09 18:19:12
5714,17,Kerala,22097731,15670747,6426984,2021-08-09 18:19:12
5715,18,Ladakh,259036,188699,70337,2021-08-09 18:19:12
5716,19,Lakshadweep,68295,51156,17139,2021-08-09 18:19:12
5717,20,Madhya Pradesh,35456676,29723036,5733640,2021-08-09 18:19:12
5718,21,Maharashtra,47153366,35040812,12112554,2021-08-09 18:19:12
5719,22,Manipur,1406118,1159424,246694,2021-08-09 18:19:12
5720,23,Meghalaya,1170554,938572,231982,2021-08-09 18:19:12
5721,24,Mizoram,861719,654946,206773,2021-08-09 18:19:12
5722,25,Nagaland,791508,632120,159388,2021-08-09 18:19:12
5723,26,Odisha,18154686,13954592,4200094,2021-08-09 18:19:12
5724,27,Puducherry,753362,601591,151771,2021-08-09 18:19:12
5725,28,Punjab,10291265,8005636,2285629,2021-08-09 18:19:12
5726,29,Rajasthan,35383662,27008606,8375056,2021-08-09 18:19:12
5727,30,Sikkim,649389,497851,151538,2021-08-09 18:19:12
5728,31,Tamil Nadu,25522708,20836674,4686034,2021-08-09 18:19:12
5729,32,Telangana,15614892,11649268,3965624,2021-08-09 18:19:12
5730,33,Tripura,3215294,2411195,804099,2021-08-09 18:19:12
5731,34,Uttar Pradesh,54447724,45932488,8515236,2021-08-09 18:19:12
5732,35,Uttarakhand,6667116,5070544,1596572,2021-08-09 18:19:12
5733,36,West Bengal,32390378,23257417,9132961,2021-08-09 18:19:12
5734,37,Daman and Diu,287791,244490,43301,2021-08-09 18:19:12
5735,1,Andaman and Nicobar Islands,311987,216938,95049,2021-08-10 18:18:59
5736,2,Andhra Pradesh,24098248,17801780,6296468,2021-08-10 18:18:59
5737,3,Arunachal Pradesh,883773,694498,189275,2021-08-10 18:18:59
5738,4,Assam,12956404,10696845,2259559,2021-08-10 18:18:59
5739,5,Bihar,28012422,23492399,4520023,2021-08-10 18:18:59
5740,6,Chandigarh,931847,705033,226814,2021-08-10 18:18:59
5741,7,Chhattisgarh,11810583,9201115,2609468,2021-08-10 18:18:59
5742,8,Dadra and Nagar Haveli,380200,342208,37992,2021-08-10 18:18:59
5743,9,Delhi,10977134,7919929,3057205,2021-08-10 18:18:59
5744,10,Goa,1405367,1098003,307364,2021-08-10 18:18:59
5745,11,Gujarat,37653837,28515173,9138664,2021-08-10 18:18:59
5746,12,Haryana,13122349,10148168,2974181,2021-08-10 18:18:59
5747,13,Himachal Pradesh,5739867,4333205,1406662,2021-08-10 18:18:59
5748,14,Jammu and Kashmir,6877370,5369343,1508027,2021-08-10 18:18:59
5749,15,Jharkhand,10461563,8443827,2017736,2021-08-10 18:18:59
5750,16,Karnataka,33491581,25983655,7507926,2021-08-10 18:18:59
5751,17,Kerala,22199834,15757389,6442445,2021-08-10 18:18:59
5752,18,Ladakh,259648,188870,70778,2021-08-10 18:18:59
5753,19,Lakshadweep,68589,51295,17294,2021-08-10 18:18:59
5754,20,Madhya Pradesh,35553678,29803485,5750193,2021-08-10 18:18:59
5755,21,Maharashtra,47480391,35241146,12239245,2021-08-10 18:18:59
5756,22,Manipur,1414282,1163214,251068,2021-08-10 18:18:59
5757,23,Meghalaya,1184549,946059,238490,2021-08-10 18:18:59
5758,24,Mizoram,864932,655861,209071,2021-08-10 18:18:59
5759,25,Nagaland,796945,634333,162612,2021-08-10 18:18:59
5760,26,Odisha,18469039,14205297,4263742,2021-08-10 18:18:59
5761,27,Puducherry,757497,604830,152667,2021-08-10 18:18:59
5762,28,Punjab,10336098,8032828,2303270,2021-08-10 18:18:59
5763,29,Rajasthan,35675147,27211189,8463958,2021-08-10 18:18:59
5764,30,Sikkim,651152,498581,152571,2021-08-10 18:18:59
5765,31,Tamil Nadu,25738106,21004877,4733229,2021-08-10 18:18:59
5766,32,Telangana,15721296,11702431,4018865,2021-08-10 18:18:59
5767,33,Tripura,3224830,2416473,808357,2021-08-10 18:18:59
5768,34,Uttar Pradesh,55031057,46413300,8617757,2021-08-10 18:18:59
5769,35,Uttarakhand,6790585,5168303,1622282,2021-08-10 18:18:59
5770,36,West Bengal,32729991,23546721,9183270,2021-08-10 18:18:59
5771,37,Daman and Diu,289360,245434,43926,2021-08-10 18:18:59
5772,1,Andaman and Nicobar Islands,314810,219316,95494,2021-08-11 18:18:42
5773,2,Andhra Pradesh,24232876,17894361,6338515,2021-08-11 18:18:42
5774,3,Arunachal Pradesh,888795,696336,192459,2021-08-11 18:18:42
5775,4,Assam,13063707,10772870,2290837,2021-08-11 18:18:42
5776,5,Bihar,28337932,23758152,4579780,2021-08-11 18:18:42
5777,6,Chandigarh,942061,711763,230298,2021-08-11 18:18:42
5778,7,Chhattisgarh,11885007,9246374,2638633,2021-08-11 18:18:42
5779,8,Dadra and Nagar Haveli,382652,344140,38512,2021-08-11 18:18:42
5780,9,Delhi,11103991,8002411,3101580,2021-08-11 18:18:42
5781,10,Goa,1413586,1101631,311955,2021-08-11 18:18:42
5782,11,Gujarat,37975741,28635476,9340265,2021-08-11 18:18:42
5783,12,Haryana,13193996,10190811,3003185,2021-08-11 18:18:42
5784,13,Himachal Pradesh,5876706,4447618,1429088,2021-08-11 18:18:42
5785,14,Jammu and Kashmir,6926150,5406082,1520068,2021-08-11 18:18:42
5786,15,Jharkhand,10608211,8558715,2049496,2021-08-11 18:18:42
5787,16,Karnataka,33795595,26186363,7609232,2021-08-11 18:18:42
5788,17,Kerala,22443788,15982422,6461366,2021-08-11 18:18:42
5789,18,Ladakh,260319,189080,71239,2021-08-11 18:18:42
5790,19,Lakshadweep,68936,51490,17446,2021-08-11 18:18:42
5791,20,Madhya Pradesh,36154709,30324868,5829841,2021-08-11 18:18:42
5792,21,Maharashtra,47746896,35420904,12325992,2021-08-11 18:18:42
5793,22,Manipur,1424590,1167320,257270,2021-08-11 18:18:42
5794,23,Meghalaya,1194945,951792,243153,2021-08-11 18:18:42
5795,24,Mizoram,869128,657191,211937,2021-08-11 18:18:42
5796,25,Nagaland,800739,636285,164454,2021-08-11 18:18:42
5797,26,Odisha,18717390,14406227,4311163,2021-08-11 18:18:42
5798,27,Puducherry,761010,607619,153391,2021-08-11 18:18:42
5799,28,Punjab,10489312,8130159,2359153,2021-08-11 18:18:42
5800,29,Rajasthan,35971880,27419230,8552650,2021-08-11 18:18:42
5801,30,Sikkim,653326,499232,154094,2021-08-11 18:18:42
5802,31,Tamil Nadu,25902265,21139553,4762712,2021-08-11 18:18:42
5803,32,Telangana,15771623,11746254,4025369,2021-08-11 18:18:42
5804,33,Tripura,3232765,2420386,812379,2021-08-11 18:18:42
5805,34,Uttar Pradesh,55519039,46816800,8702239,2021-08-11 18:18:42
5806,35,Uttarakhand,6888966,5242790,1646176,2021-08-11 18:18:42
5807,36,West Bengal,33045123,23816317,9228806,2021-08-11 18:18:42
5808,37,Daman and Diu,290940,246373,44567,2021-08-11 18:18:42
5809,1,Andaman and Nicobar Islands,319738,223754,95984,2021-08-12 18:17:54
5810,2,Andhra Pradesh,24337823,17974433,6363390,2021-08-12 18:17:54
5811,3,Arunachal Pradesh,893741,698232,195509,2021-08-12 18:17:54
5812,4,Assam,13255519,10919349,2336170,2021-08-12 18:17:54
5813,5,Bihar,28933609,24251069,4682540,2021-08-12 18:17:54
5814,6,Chandigarh,951572,717457,234115,2021-08-12 18:17:54
5815,7,Chhattisgarh,11995498,9301364,2694134,2021-08-12 18:17:54
5816,8,Dadra and Nagar Haveli,385180,346064,39116,2021-08-12 18:17:54
5817,9,Delhi,11237697,8086022,3151675,2021-08-12 18:17:54
5818,10,Goa,1420190,1104283,315907,2021-08-12 18:17:54
5819,11,Gujarat,38636565,29201125,9435440,2021-08-12 18:17:54
5820,12,Haryana,13337773,10277148,3060625,2021-08-12 18:17:54
5821,13,Himachal Pradesh,6056546,4598298,1458248,2021-08-12 18:17:54
5822,14,Jammu and Kashmir,7004340,5462875,1541465,2021-08-12 18:17:54
5823,15,Jharkhand,10717651,8638466,2079185,2021-08-12 18:17:54
5824,16,Karnataka,33928955,26266016,7662939,2021-08-12 18:17:54
5825,17,Kerala,22851378,16337139,6514239,2021-08-12 18:17:54
5826,18,Ladakh,260931,189260,71671,2021-08-12 18:17:54
5827,19,Lakshadweep,69092,51543,17549,2021-08-12 18:17:54
5828,20,Madhya Pradesh,36770924,30849427,5921497,2021-08-12 18:17:54
5829,21,Maharashtra,47937975,35554716,12383259,2021-08-12 18:17:54
5830,22,Manipur,1430884,1169861,261023,2021-08-12 18:17:54
5831,23,Meghalaya,1207362,959250,248112,2021-08-12 18:17:54
5832,24,Mizoram,873772,658513,215259,2021-08-12 18:17:54
5833,25,Nagaland,803143,637206,165937,2021-08-12 18:17:54
5834,26,Odisha,18934299,14582116,4352183,2021-08-12 18:17:54
5835,27,Puducherry,764552,610095,154457,2021-08-12 18:17:54
5836,28,Punjab,10582012,8187140,2394872,2021-08-12 18:17:54
5837,29,Rajasthan,36358050,27691421,8666629,2021-08-12 18:17:54
5838,30,Sikkim,655083,499800,155283,2021-08-12 18:17:54
5839,31,Tamil Nadu,26041258,21252105,4789153,2021-08-12 18:17:54
5840,32,Telangana,15904066,11822170,4081896,2021-08-12 18:17:54
5841,33,Tripura,3242407,2425139,817268,2021-08-12 18:17:54
5842,34,Uttar Pradesh,56335866,47513953,8821913,2021-08-12 18:17:54
5843,35,Uttarakhand,7010485,5338254,1672231,2021-08-12 18:17:54
5844,36,West Bengal,33378085,24098309,9279776,2021-08-12 18:17:54
5845,37,Daman and Diu,292791,247143,45648,2021-08-12 18:17:54
5846,1,Andaman and Nicobar Islands,324823,228316,96507,2021-08-13 18:04:42
5847,2,Andhra Pradesh,24797487,18353035,6444452,2021-08-13 18:04:42
5848,3,Arunachal Pradesh,898009,699943,198066,2021-08-13 18:04:42
5849,4,Assam,13528558,11142357,2386201,2021-08-13 18:04:42
5850,5,Bihar,29573545,24789669,4783876,2021-08-13 18:04:42
5851,6,Chandigarh,963304,724636,238668,2021-08-13 18:04:42
5852,7,Chhattisgarh,12099282,9353218,2746064,2021-08-13 18:04:42
5853,8,Dadra and Nagar Haveli,387878,347891,39987,2021-08-13 18:04:42
5854,9,Delhi,11358273,8160786,3197487,2021-08-13 18:04:42
5855,10,Goa,1428483,1107380,321103,2021-08-13 18:04:42
5856,11,Gujarat,39231916,29707258,9524658,2021-08-13 18:04:42
5857,12,Haryana,13520107,10390421,3129686,2021-08-13 18:04:42
5858,13,Himachal Pradesh,6252483,4765475,1487008,2021-08-13 18:04:42
5859,14,Jammu and Kashmir,7072370,5512193,1560177,2021-08-13 18:04:42
5860,15,Jharkhand,10794545,8693862,2100683,2021-08-13 18:04:42
5861,16,Karnataka,34132265,26399432,7732833,2021-08-13 18:04:42
5862,17,Kerala,23409696,16823042,6586654,2021-08-13 18:04:42
5863,18,Ladakh,261593,189395,72198,2021-08-13 18:04:42
5864,19,Lakshadweep,69260,51602,17658,2021-08-13 18:04:42
5865,20,Madhya Pradesh,36866725,30929084,5937641,2021-08-13 18:04:42
5866,21,Maharashtra,48227422,35754765,12472657,2021-08-13 18:04:42
5867,22,Manipur,1435272,1171910,263362,2021-08-13 18:04:42
5868,23,Meghalaya,1217802,964621,253181,2021-08-13 18:04:42
5869,24,Mizoram,876984,659610,217374,2021-08-13 18:04:42
5870,25,Nagaland,806413,638816,167597,2021-08-13 18:04:42
5871,26,Odisha,19214557,14812836,4401721,2021-08-13 18:04:42
5872,27,Puducherry,768086,612572,155514,2021-08-13 18:04:42
5873,28,Punjab,10752337,8296569,2455768,2021-08-13 18:04:42
5874,29,Rajasthan,36899655,28074399,8825256,2021-08-13 18:04:42
5875,30,Sikkim,657452,500488,156964,2021-08-13 18:04:42
5876,31,Tamil Nadu,26280240,21441992,4838248,2021-08-13 18:04:42
5877,32,Telangana,16061404,11944151,4117253,2021-08-13 18:04:42
5878,33,Tripura,3250101,2429238,820863,2021-08-13 18:04:42
5879,34,Uttar Pradesh,57076997,48140256,8936741,2021-08-13 18:04:42
5880,35,Uttarakhand,7112838,5416458,1696380,2021-08-13 18:04:42
5881,36,West Bengal,33820797,24481864,9338933,2021-08-13 18:04:42
5882,37,Daman and Diu,294573,247781,46792,2021-08-13 18:04:42
5883,1,Andaman and Nicobar Islands,329996,232709,97287,2021-08-14 18:13:38
5884,2,Andhra Pradesh,25001353,18516141,6485212,2021-08-14 18:13:38
5885,3,Arunachal Pradesh,900714,700977,199737,2021-08-14 18:13:38
5886,4,Assam,13872953,11430053,2442900,2021-08-14 18:13:38
5887,5,Bihar,30026645,25167378,4859267,2021-08-14 18:13:38
5888,6,Chandigarh,977930,733579,244351,2021-08-14 18:13:38
5889,7,Chhattisgarh,12159392,9383511,2775881,2021-08-14 18:13:38
5890,8,Dadra and Nagar Haveli,391165,349660,41505,2021-08-14 18:13:38
5891,9,Delhi,11516003,8251002,3265001,2021-08-14 18:13:38
5892,10,Goa,1442724,1112815,329909,2021-08-14 18:13:38
5893,11,Gujarat,39842827,30219308,9623519,2021-08-14 18:13:38
5894,12,Haryana,13683611,10492106,3191505,2021-08-14 18:13:38
5895,13,Himachal Pradesh,6464484,4950789,1513695,2021-08-14 18:13:38
5896,14,Jammu and Kashmir,7119659,5546227,1573432,2021-08-14 18:13:38
5897,15,Jharkhand,10932852,8797921,2134931,2021-08-14 18:13:38
5898,16,Karnataka,34499721,26662330,7837391,2021-08-14 18:13:38
5899,17,Kerala,23939504,17281691,6657813,2021-08-14 18:13:38
5900,18,Ladakh,262360,189535,72825,2021-08-14 18:13:38
5901,19,Lakshadweep,69553,51678,17875,2021-08-14 18:13:38
5902,20,Madhya Pradesh,37758265,31664637,6093628,2021-08-14 18:13:38
5903,21,Maharashtra,49197040,36383348,12813692,2021-08-14 18:13:38
5904,22,Manipur,1440236,1173886,266350,2021-08-14 18:13:38
5905,23,Meghalaya,1226159,968800,257359,2021-08-14 18:13:38
5906,24,Mizoram,877800,660109,217691,2021-08-14 18:13:38
5907,25,Nagaland,807319,639379,167940,2021-08-14 18:13:38
5908,26,Odisha,19484581,15009657,4474924,2021-08-14 18:13:38
5909,27,Puducherry,773514,616278,157236,2021-08-14 18:13:38
5910,28,Punjab,10924652,8406019,2518633,2021-08-14 18:13:38
5911,29,Rajasthan,37515341,28531782,8983559,2021-08-14 18:13:38
5912,30,Sikkim,658871,500829,158042,2021-08-14 18:13:38
5913,31,Tamil Nadu,26647484,21748109,4899375,2021-08-14 18:13:38
5914,32,Telangana,16225803,12073689,4152114,2021-08-14 18:13:38
5915,33,Tripura,3260483,2433697,826786,2021-08-14 18:13:38
5916,34,Uttar Pradesh,57428408,48248265,9180143,2021-08-14 18:13:38
5917,35,Uttarakhand,7218311,5495857,1722454,2021-08-14 18:13:38
5918,36,West Bengal,34204672,24815523,9389149,2021-08-14 18:13:38
5919,37,Daman and Diu,297636,248720,48916,2021-08-14 18:13:38
5920,1,Andaman and Nicobar Islands,330234,232929,97305,2021-08-15 18:16:14
5921,2,Andhra Pradesh,25058752,18556425,6502327,2021-08-15 18:16:14
5922,3,Arunachal Pradesh,901552,701584,199968,2021-08-15 18:16:14
5923,4,Assam,14022958,11554754,2468204,2021-08-15 18:16:14
5924,5,Bihar,30131314,25253825,4877489,2021-08-15 18:16:14
5925,6,Chandigarh,986013,738600,247413,2021-08-15 18:16:14
5926,7,Chhattisgarh,12166221,9386828,2779393,2021-08-15 18:16:14
5927,8,Dadra and Nagar Haveli,391593,349766,41827,2021-08-15 18:16:14
5928,9,Delhi,11520061,8253115,3266946,2021-08-15 18:16:14
5929,10,Goa,1447325,1114583,332742,2021-08-15 18:16:14
5930,11,Gujarat,40204914,30410830,9794084,2021-08-15 18:16:14
5931,12,Haryana,13757949,10542178,3215771,2021-08-15 18:16:14
5932,13,Himachal Pradesh,6470471,4956151,1514320,2021-08-15 18:16:14
5933,14,Jammu and Kashmir,7135861,5558724,1577137,2021-08-15 18:16:14
5934,15,Jharkhand,10969847,8825717,2144130,2021-08-15 18:16:14
5935,16,Karnataka,34646813,26771175,7875638,2021-08-15 18:16:14
5936,17,Kerala,24271550,17583743,6687807,2021-08-15 18:16:14
5937,18,Ladakh,262367,189535,72832,2021-08-15 18:16:14
5938,19,Lakshadweep,69571,51679,17892,2021-08-15 18:16:14
5939,20,Madhya Pradesh,37805519,31705912,6099607,2021-08-15 18:16:14
5940,21,Maharashtra,49417779,36542493,12875286,2021-08-15 18:16:14
5941,22,Manipur,1440610,1174116,266494,2021-08-15 18:16:14
5942,23,Meghalaya,1226483,969057,257426,2021-08-15 18:16:14
5943,24,Mizoram,878165,660312,217853,2021-08-15 18:16:14
5944,25,Nagaland,807502,639478,168024,2021-08-15 18:16:14
5945,26,Odisha,19512140,15032444,4479696,2021-08-15 18:16:14
5946,27,Puducherry,774430,616708,157722,2021-08-15 18:16:14
5947,28,Punjab,11091599,8525700,2565899,2021-08-15 18:16:14
5948,29,Rajasthan,37557660,28563880,8993780,2021-08-15 18:16:14
5949,30,Sikkim,658871,500829,158042,2021-08-15 18:16:14
5950,31,Tamil Nadu,26778920,21859148,4919772,2021-08-15 18:16:14
5951,32,Telangana,16231172,12076465,4154707,2021-08-15 18:16:14
5952,33,Tripura,3261546,2434661,826885,2021-08-15 18:16:14
5953,34,Uttar Pradesh,57439020,48253669,9185351,2021-08-15 18:16:14
5954,35,Uttarakhand,7226639,5502376,1724263,2021-08-15 18:16:14
5955,36,West Bengal,34274635,24878430,9396205,2021-08-15 18:16:14
5956,37,Daman and Diu,297916,248730,49186,2021-08-15 18:16:14
5957,1,Andaman and Nicobar Islands,332382,234575,97807,2021-08-16 18:21:26
5958,2,Andhra Pradesh,25347496,18766558,6580938,2021-08-16 18:21:26
5959,3,Arunachal Pradesh,905595,702983,202612,2021-08-16 18:21:26
5960,4,Assam,14366898,11846600,2520298,2021-08-16 18:21:26
5961,5,Bihar,30615518,25651427,4964091,2021-08-16 18:21:26
5962,6,Chandigarh,998641,746589,252052,2021-08-16 18:21:26
5963,7,Chhattisgarh,12286996,9455555,2831441,2021-08-16 18:21:26
5964,8,Dadra and Nagar Haveli,393950,351018,42932,2021-08-16 18:21:26
5965,9,Delhi,11676224,8363190,3313034,2021-08-16 18:21:26
5966,10,Goa,1456645,1118736,337909,2021-08-16 18:21:26
5967,11,Gujarat,40759153,30859695,9899458,2021-08-16 18:21:26
5968,12,Haryana,13919006,10649067,3269939,2021-08-16 18:21:26
5969,13,Himachal Pradesh,6552764,5021594,1531170,2021-08-16 18:21:26
5970,14,Jammu and Kashmir,7195481,5600986,1594495,2021-08-16 18:21:26
5971,15,Jharkhand,11097436,8923172,2174264,2021-08-16 18:21:26
5972,16,Karnataka,35087989,27087109,8000880,2021-08-16 18:21:26
5973,17,Kerala,24620672,17884914,6735758,2021-08-16 18:21:26
5974,18,Ladakh,263273,189767,73506,2021-08-16 18:21:26
5975,19,Lakshadweep,69911,51757,18154,2021-08-16 18:21:26
5976,20,Madhya Pradesh,38414175,32187427,6226748,2021-08-16 18:21:26
5977,21,Maharashtra,50051399,36976735,13074664,2021-08-16 18:21:26
5978,22,Manipur,1449454,1176035,273419,2021-08-16 18:21:26
5979,23,Meghalaya,1233795,973549,260246,2021-08-16 18:21:26
5980,24,Mizoram,881472,661326,220146,2021-08-16 18:21:26
5981,25,Nagaland,811926,640922,171004,2021-08-16 18:21:26
5982,26,Odisha,19758762,15213854,4544908,2021-08-16 18:21:26
5983,27,Puducherry,776622,617869,158753,2021-08-16 18:21:26
5984,28,Punjab,11289395,8660796,2628599,2021-08-16 18:21:26
5985,29,Rajasthan,38079373,28927453,9151920,2021-08-16 18:21:26
5986,30,Sikkim,661133,501440,159693,2021-08-16 18:21:26
5987,31,Tamil Nadu,27106162,22128142,4978020,2021-08-16 18:21:26
5988,32,Telangana,16395083,12201806,4193277,2021-08-16 18:21:26
5989,33,Tripura,3267114,2436430,830684,2021-08-16 18:21:26
5990,34,Uttar Pradesh,59719134,50357384,9361750,2021-08-16 18:21:26
5991,35,Uttarakhand,7329500,5581275,1748225,2021-08-16 18:21:26
5992,36,West Bengal,34594855,25133142,9461713,2021-08-16 18:21:26
5993,37,Daman and Diu,299864,249165,50699,2021-08-16 18:21:26
5994,1,Andaman and Nicobar Islands,334172,235835,98337,2021-08-17 18:18:40
5995,2,Andhra Pradesh,25620940,18967154,6653786,2021-08-17 18:18:40
5996,3,Arunachal Pradesh,908960,704201,204759,2021-08-17 18:18:40
5997,4,Assam,14819255,12237070,2582185,2021-08-17 18:18:40
5998,5,Bihar,30883857,25867731,5016126,2021-08-17 18:18:40
5999,6,Chandigarh,1009159,752894,256265,2021-08-17 18:18:40
6000,7,Chhattisgarh,12382748,9509337,2873411,2021-08-17 18:18:40
6001,8,Dadra and Nagar Haveli,396890,352547,44343,2021-08-17 18:18:40
6002,9,Delhi,11833625,8478252,3355373,2021-08-17 18:18:40
6003,10,Goa,1464824,1122215,342609,2021-08-17 18:18:40
6004,11,Gujarat,41261649,31265880,9995769,2021-08-17 18:18:40
6005,12,Haryana,14094714,10765382,3329332,2021-08-17 18:18:40
6006,13,Himachal Pradesh,6642413,5089044,1553369,2021-08-17 18:18:40
6007,14,Jammu and Kashmir,7250930,5639824,1611106,2021-08-17 18:18:40
6008,15,Jharkhand,11202492,9000878,2201614,2021-08-17 18:18:40
6009,16,Karnataka,35470611,27351559,8119052,2021-08-17 18:18:40
6010,17,Kerala,24966698,18190464,6776234,2021-08-17 18:18:40
6011,18,Ladakh,264029,189909,74120,2021-08-17 18:18:40
6012,19,Lakshadweep,70217,51809,18408,2021-08-17 18:18:40
6013,20,Madhya Pradesh,38503086,32259085,6244001,2021-08-17 18:18:40
6014,21,Maharashtra,50751259,37443875,13307384,2021-08-17 18:18:40
6015,22,Manipur,1454380,1177344,277036,2021-08-17 18:18:40
6016,23,Meghalaya,1242105,978832,263273,2021-08-17 18:18:40
6017,24,Mizoram,883790,662166,221624,2021-08-17 18:18:40
6018,25,Nagaland,817475,642435,175040,2021-08-17 18:18:40
6019,26,Odisha,19961650,15349497,4612153,2021-08-17 18:18:40
6020,27,Puducherry,780530,620118,160412,2021-08-17 18:18:40
6021,28,Punjab,11370349,8714872,2655477,2021-08-17 18:18:40
6022,29,Rajasthan,38420423,29183372,9237051,2021-08-17 18:18:40
6023,30,Sikkim,663136,501993,161143,2021-08-17 18:18:40
6024,31,Tamil Nadu,27387261,22349790,5037471,2021-08-17 18:18:40
6025,32,Telangana,16536083,12313403,4222680,2021-08-17 18:18:40
6026,33,Tripura,3272217,2438539,833678,2021-08-17 18:18:40
6027,34,Uttar Pradesh,60602871,51119772,9483099,2021-08-17 18:18:40
6028,35,Uttarakhand,7434625,5661560,1773065,2021-08-17 18:18:40
6029,36,West Bengal,34955712,25422878,9532834,2021-08-17 18:18:40
6030,37,Daman and Diu,301966,249778,52188,2021-08-17 18:18:40
6031,1,Andaman and Nicobar Islands,335916,236656,99260,2021-08-18 18:21:20
6032,2,Andhra Pradesh,25828597,19110872,6717725,2021-08-18 18:21:20
6033,3,Arunachal Pradesh,912580,705987,206593,2021-08-18 18:21:20
6034,4,Assam,14977919,12366046,2611873,2021-08-18 18:21:20
6035,5,Bihar,31572570,26428430,5144140,2021-08-18 18:21:20
6036,6,Chandigarh,1018836,758525,260311,2021-08-18 18:21:20
6037,7,Chhattisgarh,12456696,9553600,2903096,2021-08-18 18:21:20
6038,8,Dadra and Nagar Haveli,399220,353563,45657,2021-08-18 18:21:20
6039,9,Delhi,11971591,8579961,3391630,2021-08-18 18:21:20
6040,10,Goa,1472747,1125584,347163,2021-08-18 18:21:20
6041,11,Gujarat,41647075,31489729,10157346,2021-08-18 18:21:20
6042,12,Haryana,14222155,10849387,3372768,2021-08-18 18:21:20
6043,13,Himachal Pradesh,6706768,5136089,1570679,2021-08-18 18:21:20
6044,14,Jammu and Kashmir,7293973,5670620,1623353,2021-08-18 18:21:20
6045,15,Jharkhand,11352940,9117420,2235520,2021-08-18 18:21:20
6046,16,Karnataka,35789528,27569057,8220471,2021-08-18 18:21:20
6047,17,Kerala,25251260,18442539,6808721,2021-08-18 18:21:20
6048,18,Ladakh,264932,190083,74849,2021-08-18 18:21:20
6049,19,Lakshadweep,70626,51869,18757,2021-08-18 18:21:20
6050,20,Madhya Pradesh,39139099,32769524,6369575,2021-08-18 18:21:20
6051,21,Maharashtra,51266638,37800898,13465740,2021-08-18 18:21:20
6052,22,Manipur,1463005,1178829,284176,2021-08-18 18:21:20
6053,23,Meghalaya,1249467,982907,266560,2021-08-18 18:21:20
6054,24,Mizoram,885995,662987,223008,2021-08-18 18:21:20
6055,25,Nagaland,821147,643950,177197,2021-08-18 18:21:20
6056,26,Odisha,20171783,15487442,4684341,2021-08-18 18:21:20
6057,27,Puducherry,783766,621958,161808,2021-08-18 18:21:20
6058,28,Punjab,11614039,8891483,2722556,2021-08-18 18:21:20
6059,29,Rajasthan,38517919,29251944,9265975,2021-08-18 18:21:20
6060,30,Sikkim,664637,502305,162332,2021-08-18 18:21:20
6061,31,Tamil Nadu,27644044,22544317,5099727,2021-08-18 18:21:20
6062,32,Telangana,16559401,12332088,4227313,2021-08-18 18:21:20
6063,33,Tripura,3275989,2440129,835860,2021-08-18 18:21:20
6064,34,Uttar Pradesh,61400425,51803342,9597083,2021-08-18 18:21:20
6065,35,Uttarakhand,7505161,5714400,1790761,2021-08-18 18:21:20
6066,36,West Bengal,35231443,25620728,9610715,2021-08-18 18:21:20
6067,37,Daman and Diu,303868,250276,53592,2021-08-18 18:21:20
6068,1,Andaman and Nicobar Islands,336018,236726,99292,2021-08-19 18:19:10
6069,2,Andhra Pradesh,26045892,19235144,6810748,2021-08-19 18:19:10
6070,3,Arunachal Pradesh,915605,707230,208375,2021-08-19 18:19:10
6071,4,Assam,15178105,12527918,2650187,2021-08-19 18:19:10
6072,5,Bihar,32075685,26840130,5235555,2021-08-19 18:19:10
6073,6,Chandigarh,1028192,763758,264434,2021-08-19 18:19:10
6074,7,Chhattisgarh,12560035,9612712,2947323,2021-08-19 18:19:10
6075,8,Dadra and Nagar Haveli,401309,354473,46836,2021-08-19 18:19:10
6076,9,Delhi,12116542,8686703,3429839,2021-08-19 18:19:10
6077,10,Goa,1480001,1128598,351403,2021-08-19 18:19:10
6078,11,Gujarat,42016737,31772089,10244648,2021-08-19 18:19:10
6079,12,Haryana,14432428,10994160,3438268,2021-08-19 18:19:10
6080,13,Himachal Pradesh,6773949,5184454,1589495,2021-08-19 18:19:10
6081,14,Jammu and Kashmir,7343362,5705595,1637767,2021-08-19 18:19:10
6082,15,Jharkhand,11447697,9187697,2260000,2021-08-19 18:19:10
6083,16,Karnataka,36077702,27751607,8326095,2021-08-19 18:19:10
6084,17,Kerala,25535739,18696587,6839152,2021-08-19 18:19:10
6085,18,Ladakh,265555,190166,75389,2021-08-19 18:19:10
6086,19,Lakshadweep,70902,51934,18968,2021-08-19 18:19:10
6087,20,Madhya Pradesh,39640383,33173404,6466979,2021-08-19 18:19:10
6088,21,Maharashtra,51490796,37951382,13539414,2021-08-19 18:19:10
6089,22,Manipur,1467726,1179893,287833,2021-08-19 18:19:10
6090,23,Meghalaya,1262710,989740,272970,2021-08-19 18:19:10
6091,24,Mizoram,889288,664714,224574,2021-08-19 18:19:10
6092,25,Nagaland,823090,644594,178496,2021-08-19 18:19:10
6093,26,Odisha,20332492,15586921,4745571,2021-08-19 18:19:10
6094,27,Puducherry,786698,623429,163269,2021-08-19 18:19:10
6095,28,Punjab,11846188,9055902,2790286,2021-08-19 18:19:10
6096,29,Rajasthan,38860053,29491563,9368490,2021-08-19 18:19:10
6097,30,Sikkim,665956,502629,163327,2021-08-19 18:19:10
6098,31,Tamil Nadu,27886374,22723196,5163178,2021-08-19 18:19:10
6099,32,Telangana,16700343,12444110,4256233,2021-08-19 18:19:10
6100,33,Tripura,3280267,2441641,838626,2021-08-19 18:19:10
6101,34,Uttar Pradesh,62396549,52665700,9730849,2021-08-19 18:19:10
6102,35,Uttarakhand,7591573,5780221,1811352,2021-08-19 18:19:10
6103,36,West Bengal,35532684,25845351,9687333,2021-08-19 18:19:10
6104,37,Daman and Diu,305500,250530,54970,2021-08-19 18:19:10
6105,1,Andaman and Nicobar Islands,337837,238179,99658,2021-08-20 18:21:17
6106,2,Andhra Pradesh,26096515,19263751,6832764,2021-08-20 18:21:17
6107,3,Arunachal Pradesh,918442,708575,209867,2021-08-20 18:21:17
6108,4,Assam,15350058,12663455,2686603,2021-08-20 18:21:17
6109,5,Bihar,32194046,26940956,5253090,2021-08-20 18:21:17
6110,6,Chandigarh,1036398,768189,268209,2021-08-20 18:21:17
6111,7,Chhattisgarh,12612280,9640675,2971605,2021-08-20 18:21:17
6112,8,Dadra and Nagar Haveli,403505,355321,48184,2021-08-20 18:21:17
6113,9,Delhi,12237895,8777612,3460283,2021-08-20 18:21:17
6114,10,Goa,1487338,1131653,355685,2021-08-20 18:21:17
6115,11,Gujarat,42312743,31982463,10330280,2021-08-20 18:21:17
6116,12,Haryana,14558597,11077161,3481436,2021-08-20 18:21:17
6117,13,Himachal Pradesh,6815755,5215169,1600586,2021-08-20 18:21:17
6118,14,Jammu and Kashmir,7381949,5732758,1649191,2021-08-20 18:21:17
6119,15,Jharkhand,11525938,9239728,2286210,2021-08-20 18:21:17
6120,16,Karnataka,36269786,27885291,8384495,2021-08-20 18:21:17
6121,17,Kerala,25707370,18848332,6859038,2021-08-20 18:21:17
6122,18,Ladakh,265782,190179,75603,2021-08-20 18:21:17
6123,19,Lakshadweep,71057,51953,19104,2021-08-20 18:21:17
6124,20,Madhya Pradesh,39687276,33201134,6486142,2021-08-20 18:21:17
6125,21,Maharashtra,51893056,38220286,13672770,2021-08-20 18:21:17
6126,22,Manipur,1473588,1181164,292424,2021-08-20 18:21:17
6127,23,Meghalaya,1273306,994954,278352,2021-08-20 18:21:17
6128,24,Mizoram,891461,665634,225827,2021-08-20 18:21:17
6129,25,Nagaland,825492,645807,179685,2021-08-20 18:21:17
6130,26,Odisha,20423455,15630632,4792823,2021-08-20 18:21:17
6131,27,Puducherry,787926,623858,164068,2021-08-20 18:21:17
6132,28,Punjab,11901633,9094455,2807178,2021-08-20 18:21:17
6133,29,Rajasthan,39295307,29808272,9487035,2021-08-20 18:21:17
6134,30,Sikkim,667404,503326,164078,2021-08-20 18:21:17
6135,31,Tamil Nadu,28026568,22813071,5213497,2021-08-20 18:21:17
6136,32,Telangana,16765148,12495741,4269407,2021-08-20 18:21:17
6137,33,Tripura,3286280,2443917,842363,2021-08-20 18:21:17
6138,34,Uttar Pradesh,63124748,53292226,9832522,2021-08-20 18:21:17
6139,35,Uttarakhand,7651999,5826433,1825566,2021-08-20 18:21:17
6140,36,West Bengal,35732638,25982305,9750333,2021-08-20 18:21:17
6141,37,Daman and Diu,307613,250785,56828,2021-08-20 18:21:17
6142,1,Andaman and Nicobar Islands,338649,238494,100155,2021-08-21 18:21:03
6143,2,Andhra Pradesh,26376494,19397710,6978784,2021-08-21 18:21:03
6144,3,Arunachal Pradesh,920803,709533,211270,2021-08-21 18:21:03
6145,4,Assam,15505770,12778164,2727606,2021-08-21 18:21:03
6146,5,Bihar,32340754,27047653,5293101,2021-08-21 18:21:03
6147,6,Chandigarh,1044255,772137,272118,2021-08-21 18:21:03
6148,7,Chhattisgarh,12661122,9667452,2993670,2021-08-21 18:21:03
6149,8,Dadra and Nagar Haveli,406270,356231,50039,2021-08-21 18:21:03
6150,9,Delhi,12326273,8839655,3486618,2021-08-21 18:21:03
6151,10,Goa,1500389,1136525,363864,2021-08-21 18:21:03
6152,11,Gujarat,42704072,32261271,10442801,2021-08-21 18:21:03
6153,12,Haryana,14675219,11151301,3523918,2021-08-21 18:21:03
6154,13,Himachal Pradesh,6864488,5249599,1614889,2021-08-21 18:21:03
6155,14,Jammu and Kashmir,7425649,5764782,1660867,2021-08-21 18:21:03
6156,15,Jharkhand,11586047,9281466,2304581,2021-08-21 18:21:03
6157,16,Karnataka,36757979,28186372,8571607,2021-08-21 18:21:03
6158,17,Kerala,25732732,18871478,6861254,2021-08-21 18:21:03
6159,18,Ladakh,267490,190402,77088,2021-08-21 18:21:03
6160,19,Lakshadweep,71168,51970,19198,2021-08-21 18:21:03
6161,20,Madhya Pradesh,40132616,33549545,6583071,2021-08-21 18:21:03
6162,21,Maharashtra,53001820,38992443,14009377,2021-08-21 18:21:03
6163,22,Manipur,1479234,1182201,297033,2021-08-21 18:21:03
6164,23,Meghalaya,1281244,998776,282468,2021-08-21 18:21:03
6165,24,Mizoram,891467,665491,225976,2021-08-21 18:21:03
6166,25,Nagaland,826449,646190,180259,2021-08-21 18:21:03
6167,26,Odisha,20501449,15667462,4833987,2021-08-21 18:21:03
6168,27,Puducherry,790559,624896,165663,2021-08-21 18:21:03
6169,28,Punjab,12155292,9276644,2878648,2021-08-21 18:21:03
6170,29,Rajasthan,39730502,30118587,9611915,2021-08-21 18:21:03
6171,30,Sikkim,667998,503480,164518,2021-08-21 18:21:03
6172,31,Tamil Nadu,28400390,23049434,5350956,2021-08-21 18:21:03
6173,32,Telangana,16862285,12568019,4294266,2021-08-21 18:21:03
6174,33,Tripura,3292339,2445730,846609,2021-08-21 18:21:03
6175,34,Uttar Pradesh,63438015,53346052,10091963,2021-08-21 18:21:03
6176,35,Uttarakhand,7727133,5882552,1844581,2021-08-21 18:21:03
6177,36,West Bengal,36085861,26205111,9880750,2021-08-21 18:21:03
6178,37,Daman and Diu,310695,251121,59574,2021-08-21 18:21:03
6179,1,Andaman and Nicobar Islands,338804,238632,100172,2021-08-22 18:08:25
6180,2,Andhra Pradesh,26392373,19407130,6985243,2021-08-22 18:08:25
6181,3,Arunachal Pradesh,921474,709957,211517,2021-08-22 18:08:25
6182,4,Assam,15544229,12806104,2738125,2021-08-22 18:08:25
6183,5,Bihar,32385361,27084998,5300363,2021-08-22 18:08:25
6184,6,Chandigarh,1044400,772206,272194,2021-08-22 18:08:25
6185,7,Chhattisgarh,12664612,9669567,2995045,2021-08-22 18:08:25
6186,8,Dadra and Nagar Haveli,406297,356256,50041,2021-08-22 18:08:25
6187,9,Delhi,12331595,8843029,3488566,2021-08-22 18:08:25
6188,10,Goa,1504657,1138119,366538,2021-08-22 18:08:25
6189,11,Gujarat,42711935,32266676,10445259,2021-08-22 18:08:25
6190,12,Haryana,14685406,11157831,3527575,2021-08-22 18:08:25
6191,13,Himachal Pradesh,6865755,5250505,1615250,2021-08-22 18:08:25
6192,14,Jammu and Kashmir,7459081,5789678,1669403,2021-08-22 18:08:25
6193,15,Jharkhand,11637614,9320808,2316806,2021-08-22 18:08:25
6194,16,Karnataka,36961711,28315377,8646334,2021-08-22 18:08:25
6195,17,Kerala,25828756,18958757,6869999,2021-08-22 18:08:25
6196,18,Ladakh,267495,190402,77093,2021-08-22 18:08:25
6197,19,Lakshadweep,71427,52015,19412,2021-08-22 18:08:25
6198,20,Madhya Pradesh,40155466,33569896,6585570,2021-08-22 18:08:25
6199,21,Maharashtra,53108876,39068649,14040227,2021-08-22 18:08:25
6200,22,Manipur,1480563,1182619,297944,2021-08-22 18:08:25
6201,23,Meghalaya,1281664,999069,282595,2021-08-22 18:08:25
6202,24,Mizoram,891467,665491,225976,2021-08-22 18:08:25
6203,25,Nagaland,826881,646381,180500,2021-08-22 18:08:25
6204,26,Odisha,20511039,15674261,4836778,2021-08-22 18:08:25
6205,27,Puducherry,791779,625280,166499,2021-08-22 18:08:25
6206,28,Punjab,12173653,9291146,2882507,2021-08-22 18:08:25
6207,29,Rajasthan,39750465,30133742,9616723,2021-08-22 18:08:25
6208,30,Sikkim,667998,503480,164518,2021-08-22 18:08:25
6209,31,Tamil Nadu,28619135,23199098,5420037,2021-08-22 18:08:25
6210,32,Telangana,16868907,12571032,4297875,2021-08-22 18:08:25
6211,33,Tripura,3292968,2446241,846727,2021-08-22 18:08:25
6212,34,Uttar Pradesh,63490334,53392597,10097737,2021-08-22 18:08:25
6213,35,Uttarakhand,7730236,5884620,1845616,2021-08-22 18:08:25
6214,36,West Bengal,36189171,26271758,9917413,2021-08-22 18:08:25
6215,37,Daman and Diu,310695,251121,59574,2021-08-22 18:08:25
6216,1,Andaman and Nicobar Islands,342919,241644,101275,2021-08-23 18:08:15
6217,2,Andhra Pradesh,26617476,19536901,7080575,2021-08-23 18:08:15
6218,3,Arunachal Pradesh,924980,711689,213291,2021-08-23 18:08:15
6219,4,Assam,15824476,13027506,2796970,2021-08-23 18:08:15
6220,5,Bihar,32803781,27414306,5389475,2021-08-23 18:08:15
6221,6,Chandigarh,1053291,777153,276138,2021-08-23 18:08:15
6222,7,Chhattisgarh,12727464,9701510,3025954,2021-08-23 18:08:15
6223,8,Dadra and Nagar Haveli,409056,357290,51766,2021-08-23 18:08:15
6224,9,Delhi,12474885,8943198,3531687,2021-08-23 18:08:15
6225,10,Goa,1513312,1142022,371290,2021-08-23 18:08:15
6226,11,Gujarat,43209673,32617832,10591841,2021-08-23 18:08:15
6227,12,Haryana,14837835,11254600,3583235,2021-08-23 18:08:15
6228,13,Himachal Pradesh,6918327,5283826,1634501,2021-08-23 18:08:15
6229,14,Jammu and Kashmir,7540685,5845988,1694697,2021-08-23 18:08:15
6230,15,Jharkhand,11801666,9445511,2356155,2021-08-23 18:08:15
6231,16,Karnataka,37534230,28699161,8835069,2021-08-23 18:08:15
6232,17,Kerala,26271086,19322808,6948278,2021-08-23 18:08:15
6233,18,Ladakh,270676,190799,79877,2021-08-23 18:08:15
6234,19,Lakshadweep,71915,52100,19815,2021-08-23 18:08:15
6235,20,Madhya Pradesh,40194021,33592605,6601416,2021-08-23 18:08:15
6236,21,Maharashtra,53904343,39634652,14269691,2021-08-23 18:08:15
6237,22,Manipur,1487866,1184233,303633,2021-08-23 18:08:15
6238,23,Meghalaya,1290770,1003690,287080,2021-08-23 18:08:15
6239,24,Mizoram,893912,666123,227789,2021-08-23 18:08:15
6240,25,Nagaland,831387,647574,183813,2021-08-23 18:08:15
6241,26,Odisha,20738805,15838232,4900573,2021-08-23 18:08:15
6242,27,Puducherry,795834,627086,168748,2021-08-23 18:08:15
6243,28,Punjab,12258485,9350489,2907996,2021-08-23 18:08:15
6244,29,Rajasthan,39966590,30289408,9677182,2021-08-23 18:08:15
6245,30,Sikkim,669161,504063,165098,2021-08-23 18:08:15
6246,31,Tamil Nadu,29036043,23484109,5551934,2021-08-23 18:08:15
6247,32,Telangana,16998366,12670483,4327883,2021-08-23 18:08:15
6248,33,Tripura,3301920,2448215,853705,2021-08-23 18:08:15
6249,34,Uttar Pradesh,64223940,54022400,10201540,2021-08-23 18:08:15
6250,35,Uttarakhand,7827097,5958654,1868443,2021-08-23 18:08:15
6251,36,West Bengal,36707720,26581297,10126423,2021-08-23 18:08:15
6252,37,Daman and Diu,313389,251487,61902,2021-08-23 18:08:15
6253,1,Andaman and Nicobar Islands,346691,244619,102072,2021-08-24 18:15:31
6254,2,Andhra Pradesh,26879642,19682912,7196730,2021-08-24 18:15:31
6255,3,Arunachal Pradesh,928057,712974,215083,2021-08-24 18:15:31
6256,4,Assam,16095007,13246554,2848453,2021-08-24 18:15:31
6257,5,Bihar,33038455,27592696,5445759,2021-08-24 18:15:31
6258,6,Chandigarh,1061404,781165,280239,2021-08-24 18:15:31
6259,7,Chhattisgarh,12768949,9723100,3045849,2021-08-24 18:15:31
6260,8,Dadra and Nagar Haveli,411669,358152,53517,2021-08-24 18:15:31
6261,9,Delhi,12620139,9045542,3574597,2021-08-24 18:15:31
6262,10,Goa,1521833,1145426,376407,2021-08-24 18:15:31
6263,11,Gujarat,43666858,32934336,10732522,2021-08-24 18:15:31
6264,12,Haryana,15061412,11410487,3650925,2021-08-24 18:15:31
6265,13,Himachal Pradesh,6972767,5317699,1655068,2021-08-24 18:15:31
6266,14,Jammu and Kashmir,7612165,5894743,1717422,2021-08-24 18:15:31
6267,15,Jharkhand,11978587,9585976,2392611,2021-08-24 18:15:31
6268,16,Karnataka,37919138,28940673,8978465,2021-08-24 18:15:31
6269,17,Kerala,26596185,19547185,7049000,2021-08-24 18:15:31
6270,18,Ladakh,275706,191241,84465,2021-08-24 18:15:31
6271,19,Lakshadweep,72360,52151,20209,2021-08-24 18:15:31
6272,20,Madhya Pradesh,40205070,33599774,6605296,2021-08-24 18:15:31
6273,21,Maharashtra,54459876,40003859,14456017,2021-08-24 18:15:31
6274,22,Manipur,1492149,1185270,306879,2021-08-24 18:15:31
6275,23,Meghalaya,1298462,1007774,290688,2021-08-24 18:15:31
6276,24,Mizoram,897042,667463,229579,2021-08-24 18:15:31
6277,25,Nagaland,836318,649055,187263,2021-08-24 18:15:31
6278,26,Odisha,20951921,15980969,4970952,2021-08-24 18:15:31
6279,27,Puducherry,799269,628597,170672,2021-08-24 18:15:31
6280,28,Punjab,12597966,9603714,2994252,2021-08-24 18:15:31
6281,29,Rajasthan,40597908,30756546,9841362,2021-08-24 18:15:31
6282,30,Sikkim,669771,504320,165451,2021-08-24 18:15:31
6283,31,Tamil Nadu,29409869,23754296,5655573,2021-08-24 18:15:31
6284,32,Telangana,17133914,12773848,4360066,2021-08-24 18:15:31
6285,33,Tripura,3309892,2450246,859646,2021-08-24 18:15:31
6286,34,Uttar Pradesh,65217684,54874596,10343088,2021-08-24 18:15:31
6287,35,Uttarakhand,7916218,6025049,1891169,2021-08-24 18:15:31
6288,36,West Bengal,37167763,26857878,10309885,2021-08-24 18:15:31
6289,37,Daman and Diu,316125,251832,64293,2021-08-24 18:15:31
6290,1,Andaman and Nicobar Islands,350561,247531,103030,2021-08-25 18:15:59
6291,2,Andhra Pradesh,27097352,19796903,7300449,2021-08-25 18:15:59
6292,3,Arunachal Pradesh,932351,714596,217755,2021-08-25 18:15:59
6293,4,Assam,16239517,13360387,2879130,2021-08-25 18:15:59
6294,5,Bihar,33709657,28141071,5568586,2021-08-25 18:15:59
6295,6,Chandigarh,1069336,784984,284352,2021-08-25 18:15:59
6296,7,Chhattisgarh,12818205,9750579,3067626,2021-08-25 18:15:59
6297,8,Dadra and Nagar Haveli,414004,358989,55015,2021-08-25 18:15:59
6298,9,Delhi,12719271,9112764,3606507,2021-08-25 18:15:59
6299,10,Goa,1529465,1148528,380937,2021-08-25 18:15:59
6300,11,Gujarat,44007105,33116480,10890625,2021-08-25 18:15:59
6301,12,Haryana,15161459,11473774,3687685,2021-08-25 18:15:59
6302,13,Himachal Pradesh,7029863,5356000,1673863,2021-08-25 18:15:59
6303,14,Jammu and Kashmir,7661522,5928982,1732540,2021-08-25 18:15:59
6304,15,Jharkhand,12136472,9711731,2424741,2021-08-25 18:15:59
6305,16,Karnataka,38448007,29291377,9156630,2021-08-25 18:15:59
6306,17,Kerala,27012910,19852677,7160233,2021-08-25 18:15:59
6307,18,Ladakh,279575,191651,87924,2021-08-25 18:15:59
6308,19,Lakshadweep,72944,52229,20715,2021-08-25 18:15:59
6309,20,Madhya Pradesh,42610391,35465223,7145168,2021-08-25 18:15:59
6310,21,Maharashtra,54864611,40270287,14594324,2021-08-25 18:15:59
6311,22,Manipur,1499974,1186693,313281,2021-08-25 18:15:59
6312,23,Meghalaya,1305255,1011305,293950,2021-08-25 18:15:59
6313,24,Mizoram,898972,668137,230835,2021-08-25 18:15:59
6314,25,Nagaland,839996,650207,189789,2021-08-25 18:15:59
6315,26,Odisha,21075970,16053830,5022140,2021-08-25 18:15:59
6316,27,Puducherry,803079,630303,172776,2021-08-25 18:15:59
6317,28,Punjab,12713278,9685900,3027378,2021-08-25 18:15:59
6318,29,Rajasthan,41130946,31158868,9972078,2021-08-25 18:15:59
6319,30,Sikkim,670340,504634,165706,2021-08-25 18:15:59
6320,31,Tamil Nadu,29783889,24027611,5756278,2021-08-25 18:15:59
6321,32,Telangana,17183415,12810397,4373018,2021-08-25 18:15:59
6322,33,Tripura,3315589,2451708,863881,2021-08-25 18:15:59
6323,34,Uttar Pradesh,66077842,55590684,10487158,2021-08-25 18:15:59
6324,35,Uttarakhand,7984427,6074506,1909921,2021-08-25 18:15:59
6325,36,West Bengal,37647036,27148098,10498938,2021-08-25 18:15:59
6326,37,Daman and Diu,318721,252224,66497,2021-08-25 18:15:59
6327,1,Andaman and Nicobar Islands,353265,249774,103491,2021-08-26 18:16:01
6328,2,Andhra Pradesh,27462034,20000157,7461877,2021-08-26 18:16:01
6329,3,Arunachal Pradesh,937102,716099,221003,2021-08-26 18:16:01
6330,4,Assam,16484825,13559101,2925724,2021-08-26 18:16:01
6331,5,Bihar,34231924,28568034,5663890,2021-08-26 18:16:01
6332,6,Chandigarh,1077605,789037,288568,2021-08-26 18:16:01
6333,7,Chhattisgarh,12934731,9821573,3113158,2021-08-26 18:16:01
6334,8,Dadra and Nagar Haveli,415933,359618,56315,2021-08-26 18:16:01
6335,9,Delhi,12878385,9223737,3654648,2021-08-26 18:16:01
6336,10,Goa,1537469,1151573,385896,2021-08-26 18:16:01
6337,11,Gujarat,44578268,33508125,11070143,2021-08-26 18:16:01
6338,12,Haryana,15265018,11534721,3730297,2021-08-26 18:16:01
6339,13,Himachal Pradesh,7089032,5395597,1693435,2021-08-26 18:16:01
6340,14,Jammu and Kashmir,7708953,5962303,1746650,2021-08-26 18:16:01
6341,15,Jharkhand,12256223,9803847,2452376,2021-08-26 18:16:01
6342,16,Karnataka,38907375,29591747,9315628,2021-08-26 18:16:01
6343,17,Kerala,27264922,20012398,7252524,2021-08-26 18:16:01
6344,18,Ladakh,283299,192074,91225,2021-08-26 18:16:01
6345,19,Lakshadweep,73651,52306,21345,2021-08-26 18:16:01
6346,20,Madhya Pradesh,44488837,36849041,7639796,2021-08-26 18:16:01
6347,21,Maharashtra,55330721,40572710,14758011,2021-08-26 18:16:01
6348,22,Manipur,1503658,1187651,316007,2021-08-26 18:16:01
6349,23,Meghalaya,1311967,1014543,297424,2021-08-26 18:16:01
6350,24,Mizoram,900339,668821,231518,2021-08-26 18:16:01
6351,25,Nagaland,842630,650884,191746,2021-08-26 18:16:01
6352,26,Odisha,21205664,16134673,5070991,2021-08-26 18:16:01
6353,27,Puducherry,806288,631683,174605,2021-08-26 18:16:01
6354,28,Punjab,13003730,9905388,3098342,2021-08-26 18:16:01
6355,29,Rajasthan,41730862,31611122,10119740,2021-08-26 18:16:01
6356,30,Sikkim,671126,504968,166158,2021-08-26 18:16:01
6357,31,Tamil Nadu,30288553,24384518,5904035,2021-08-26 18:16:01
6358,32,Telangana,17332552,12921547,4411005,2021-08-26 18:16:01
6359,33,Tripura,3324329,2453884,870445,2021-08-26 18:16:01
6360,34,Uttar Pradesh,66841662,56214771,10626891,2021-08-26 18:16:01
6361,35,Uttarakhand,8087559,6155360,1932199,2021-08-26 18:16:01
6362,36,West Bengal,38064152,27403081,10661071,2021-08-26 18:16:01
6363,37,Daman and Diu,320988,252489,68499,2021-08-26 18:16:01
6364,1,Andaman and Nicobar Islands,355623,251613,104010,2021-08-27 18:13:29
6365,2,Andhra Pradesh,27796991,20166558,7630433,2021-08-27 18:13:29
6366,3,Arunachal Pradesh,943542,718280,225262,2021-08-27 18:13:29
6367,4,Assam,16749571,13774704,2974867,2021-08-27 18:13:29
6368,5,Bihar,34844644,29065666,5778978,2021-08-27 18:13:29
6369,6,Chandigarh,1087842,793611,294231,2021-08-27 18:13:29
6370,7,Chhattisgarh,13007095,9866375,3140720,2021-08-27 18:13:29
6371,8,Dadra and Nagar Haveli,418808,360588,58220,2021-08-27 18:13:29
6372,9,Delhi,13032125,9328243,3703882,2021-08-27 18:13:29
6373,10,Goa,1546347,1154536,391811,2021-08-27 18:13:29
6374,11,Gujarat,45088262,33857297,11230965,2021-08-27 18:13:29
6375,12,Haryana,15918141,11959101,3959040,2021-08-27 18:13:29
6376,13,Himachal Pradesh,7143678,5432250,1711428,2021-08-27 18:13:29
6377,14,Jammu and Kashmir,7753703,5996484,1757219,2021-08-27 18:13:29
6378,15,Jharkhand,12359425,9883041,2476384,2021-08-27 18:13:29
6379,16,Karnataka,40022027,30362920,9659107,2021-08-27 18:13:29
6380,17,Kerala,27751639,20362836,7388803,2021-08-27 18:13:29
6381,18,Ladakh,286069,192411,93658,2021-08-27 18:13:29
6382,19,Lakshadweep,74309,52370,21939,2021-08-27 18:13:29
6383,20,Madhya Pradesh,44604095,36935497,7668598,2021-08-27 18:13:29
6384,21,Maharashtra,56330158,41234879,15095279,2021-08-27 18:13:29
6385,22,Manipur,1511382,1189275,322107,2021-08-27 18:13:29
6386,23,Meghalaya,1318708,1017905,300803,2021-08-27 18:13:29
6387,24,Mizoram,902932,669369,233563,2021-08-27 18:13:29
6388,25,Nagaland,846206,652171,194035,2021-08-27 18:13:29
6389,26,Odisha,21489205,16326968,5162237,2021-08-27 18:13:29
6390,27,Puducherry,809698,633104,176594,2021-08-27 18:13:29
6391,28,Punjab,13118717,9987718,3130999,2021-08-27 18:13:29
6392,29,Rajasthan,42232089,31980576,10251513,2021-08-27 18:13:29
6393,30,Sikkim,671915,505405,166510,2021-08-27 18:13:29
6394,31,Tamil Nadu,30767569,24722975,6044594,2021-08-27 18:13:29
6395,32,Telangana,17479423,13022396,4457027,2021-08-27 18:13:29
6396,33,Tripura,3328245,2455626,872619,2021-08-27 18:13:29
6397,34,Uttar Pradesh,69806995,58861294,10945701,2021-08-27 18:13:29
6398,35,Uttarakhand,8194137,6239601,1954536,2021-08-27 18:13:29
6399,36,West Bengal,38627951,27752589,10875362,2021-08-27 18:13:29
6400,37,Daman and Diu,323559,252941,70618,2021-08-27 18:13:29
6401,1,Andaman and Nicobar Islands,359012,254193,104819,2021-08-28 17:34:20
6402,2,Andhra Pradesh,28749800,20768271,7981529,2021-08-28 17:34:20
6403,3,Arunachal Pradesh,949817,719880,229937,2021-08-28 17:34:20
6404,4,Assam,17018313,13992661,3025652,2021-08-28 17:34:20
6405,5,Bihar,35281659,29406992,5874667,2021-08-28 17:34:20
6406,6,Chandigarh,1098550,798036,300514,2021-08-28 17:34:20
6407,7,Chhattisgarh,13086909,9913186,3173723,2021-08-28 17:34:20
6408,8,Dadra and Nagar Haveli,422262,361607,60655,2021-08-28 17:34:20
6409,9,Delhi,13217973,9449494,3768479,2021-08-28 17:34:20
6410,10,Goa,1560930,1158876,402054,2021-08-28 17:34:20
6411,11,Gujarat,45489901,34133006,11356895,2021-08-28 17:34:20
6412,12,Haryana,16127310,12086695,4040615,2021-08-28 17:34:20
6413,13,Himachal Pradesh,7190361,5461406,1728955,2021-08-28 17:34:20
6414,14,Jammu and Kashmir,7793214,6025328,1767886,2021-08-28 17:34:20
6415,15,Jharkhand,12441731,9943368,2498363,2021-08-28 17:34:20
6416,16,Karnataka,40728915,30823005,9905910,2021-08-28 17:34:20
6417,17,Kerala,27950601,20496895,7453706,2021-08-28 17:34:20
6418,18,Ladakh,289182,192756,96426,2021-08-28 17:34:20
6419,19,Lakshadweep,74966,52457,22509,2021-08-28 17:34:20
6420,20,Madhya Pradesh,45390951,37492295,7898656,2021-08-28 17:34:20
6421,21,Maharashtra,57039029,41662275,15376754,2021-08-28 17:34:20
6422,22,Manipur,1518499,1190560,327939,2021-08-28 17:34:20
6423,23,Meghalaya,1323888,1020190,303698,2021-08-28 17:34:20
6424,24,Mizoram,903594,669582,234012,2021-08-28 17:34:20
6425,25,Nagaland,846948,652454,194494,2021-08-28 17:34:20
6426,26,Odisha,21757382,16501332,5256050,2021-08-28 17:34:20
6427,27,Puducherry,814723,635144,179579,2021-08-28 17:34:20
6428,28,Punjab,13184375,10028631,3155744,2021-08-28 17:34:20
6429,29,Rajasthan,42647282,32283693,10363589,2021-08-28 17:34:20
6430,30,Sikkim,672386,505635,166751,2021-08-28 17:34:20
6431,31,Tamil Nadu,31250471,25060958,6189513,2021-08-28 17:34:20
6432,32,Telangana,17653713,13136746,4516967,2021-08-28 17:34:20
6433,33,Tripura,3336249,2457835,878414,2021-08-28 17:34:20
6434,34,Uttar Pradesh,70440918,59123422,11317496,2021-08-28 17:34:20
6435,35,Uttarakhand,8304211,6323589,1980622,2021-08-28 17:34:20
6436,36,West Bengal,39139256,28076619,11062637,2021-08-28 17:34:20
6437,37,Daman and Diu,327643,253367,74276,2021-08-28 17:34:20
6438,1,Andaman and Nicobar Islands,359310,254459,104851,2021-08-29 18:11:24
6439,2,Andhra Pradesh,28938438,20884430,8054008,2021-08-29 18:11:24
6440,3,Arunachal Pradesh,953073,721014,232059,2021-08-29 18:11:24
6441,4,Assam,17111119,14069446,3041673,2021-08-29 18:11:24
6442,5,Bihar,35450607,29542976,5907631,2021-08-29 18:11:24
6443,6,Chandigarh,1102461,799733,302728,2021-08-29 18:11:24
6444,7,Chhattisgarh,13153883,9952861,3201022,2021-08-29 18:11:24
6445,8,Dadra and Nagar Haveli,423106,361823,61283,2021-08-29 18:11:24
6446,9,Delhi,13228839,9452899,3775940,2021-08-29 18:11:24
6447,10,Goa,1567330,1160765,406565,2021-08-29 18:11:24
6448,11,Gujarat,45507920,34146808,11361112,2021-08-29 18:11:24
6449,12,Haryana,16191860,12126966,4064894,2021-08-29 18:11:24
6450,13,Himachal Pradesh,7197259,5466717,1730542,2021-08-29 18:11:24
6451,14,Jammu and Kashmir,7888820,6095672,1793148,2021-08-29 18:11:24
6452,15,Jharkhand,12603211,10066082,2537129,2021-08-29 18:11:24
6453,16,Karnataka,41046230,31044960,10001270,2021-08-29 18:11:24
6454,17,Kerala,28152388,20645798,7506590,2021-08-29 18:11:24
6455,18,Ladakh,289442,192771,96671,2021-08-29 18:11:24
6456,19,Lakshadweep,75648,52501,23147,2021-08-29 18:11:24
6457,20,Madhya Pradesh,45527411,37582880,7944531,2021-08-29 18:11:24
6458,21,Maharashtra,57166481,41731612,15434869,2021-08-29 18:11:24
6459,22,Manipur,1520028,1191377,328651,2021-08-29 18:11:24
6460,23,Meghalaya,1324165,1020349,303816,2021-08-29 18:11:24
6461,24,Mizoram,903594,669582,234012,2021-08-29 18:11:24
6462,25,Nagaland,847589,652658,194931,2021-08-29 18:11:24
6463,26,Odisha,21793929,16528189,5265740,2021-08-29 18:11:24
6464,27,Puducherry,816640,635757,180883,2021-08-29 18:11:24
6465,28,Punjab,13227667,10057353,3170314,2021-08-29 18:11:24
6466,29,Rajasthan,43710397,33086073,10624324,2021-08-29 18:11:24
6467,30,Sikkim,672416,505665,166751,2021-08-29 18:11:24
6468,31,Tamil Nadu,31597059,25316571,6280488,2021-08-29 18:11:24
6469,32,Telangana,17707481,13170053,4537428,2021-08-29 18:11:24
6470,33,Tripura,3336744,2458222,878522,2021-08-29 18:11:24
6471,34,Uttar Pradesh,70480959,59147744,11333215,2021-08-29 18:11:24
6472,35,Uttarakhand,8383166,6385277,1997889,2021-08-29 18:11:24
6473,36,West Bengal,39439630,28296675,11142955,2021-08-29 18:11:24
6474,37,Daman and Diu,327731,253367,74364,2021-08-29 18:11:24
6475,1,Andaman and Nicobar Islands,360781,255747,105034,2021-08-30 17:34:09
6476,2,Andhra Pradesh,29325592,21140321,8185271,2021-08-30 17:34:09
6477,3,Arunachal Pradesh,961992,723939,238053,2021-08-30 17:34:09
6478,4,Assam,17287101,14209524,3077577,2021-08-30 17:34:09
6479,5,Bihar,35539375,29613388,5925987,2021-08-30 17:34:09
6480,6,Chandigarh,1107843,802978,304865,2021-08-30 17:34:09
6481,7,Chhattisgarh,13184137,9968480,3215657,2021-08-30 17:34:09
6482,8,Dadra and Nagar Haveli,425088,362681,62407,2021-08-30 17:34:09
6483,9,Delhi,13382650,9559710,3822940,2021-08-30 17:34:09
6484,10,Goa,1576851,1163632,413219,2021-08-30 17:34:09
6485,11,Gujarat,45511180,34148183,11362997,2021-08-30 17:34:09
6486,12,Haryana,16216347,12139664,4076683,2021-08-30 17:34:09
6487,13,Himachal Pradesh,7206459,5472735,1733724,2021-08-30 17:34:09
6488,14,Jammu and Kashmir,7964405,6152623,1811782,2021-08-30 17:34:09
6489,15,Jharkhand,12750620,10179640,2570980,2021-08-30 17:34:09
6490,16,Karnataka,41752250,31564257,10187993,2021-08-30 17:34:09
6491,17,Kerala,28634882,20978616,7656266,2021-08-30 17:34:09
6492,18,Ladakh,292708,193272,99436,2021-08-30 17:34:09
6493,19,Lakshadweep,75891,52520,23371,2021-08-30 17:34:09
6494,20,Madhya Pradesh,45560651,37597662,7962989,2021-08-30 17:34:09
6495,21,Maharashtra,58196886,42430499,15766387,2021-08-30 17:34:09
6496,22,Manipur,1524444,1192731,331713,2021-08-30 17:34:09
6497,23,Meghalaya,1330151,1023112,307039,2021-08-30 17:34:09
6498,24,Mizoram,905569,669821,235748,2021-08-30 17:34:09
6499,25,Nagaland,850226,653322,196904,2021-08-30 17:34:09
6500,26,Odisha,22011553,16689877,5321676,2021-08-30 17:34:09
6501,27,Puducherry,821413,637918,183495,2021-08-30 17:34:09
6502,28,Punjab,13284273,10099458,3184815,2021-08-30 17:34:09
6503,29,Rajasthan,43908941,33229532,10679409,2021-08-30 17:34:09
6504,30,Sikkim,672658,505789,166869,2021-08-30 17:34:09
6505,31,Tamil Nadu,32101552,25699120,6402432,2021-08-30 17:34:09
6506,32,Telangana,17880538,13289709,4590829,2021-08-30 17:34:09
6507,33,Tripura,3338850,2458960,879890,2021-08-30 17:34:09
6508,34,Uttar Pradesh,71516791,60035486,11481305,2021-08-30 17:34:09
6509,35,Uttarakhand,8419821,6413799,2006022,2021-08-30 17:34:09
6510,36,West Bengal,39833670,28570244,11263426,2021-08-30 17:34:09
6511,37,Daman and Diu,329580,253637,75943,2021-08-30 17:34:09
6512,1,Andaman and Nicobar Islands,363253,257452,105801,2021-08-31 18:15:45
6513,2,Andhra Pradesh,30570824,21981121,8589703,2021-08-31 18:15:45
6514,3,Arunachal Pradesh,969341,726441,242900,2021-08-31 18:15:45
6515,4,Assam,17549291,14421757,3127534,2021-08-31 18:15:45
6516,5,Bihar,37935447,31666711,6268736,2021-08-31 18:15:45
6517,6,Chandigarh,1115455,807067,308388,2021-08-31 18:15:45
6518,7,Chhattisgarh,13247860,10007608,3240252,2021-08-31 18:15:45
6519,8,Dadra and Nagar Haveli,427043,363299,63744,2021-08-31 18:15:45
6520,9,Delhi,13518575,9657498,3861077,2021-08-31 18:15:45
6521,10,Goa,1586566,1166210,420356,2021-08-31 18:15:45
6522,11,Gujarat,46380456,34693216,11687240,2021-08-31 18:15:45
6523,12,Haryana,16378395,12254102,4124293,2021-08-31 18:15:45
6524,13,Himachal Pradesh,7242055,5492943,1749112,2021-08-31 18:15:45
6525,14,Jammu and Kashmir,8098262,6250364,1847898,2021-08-31 18:15:45
6526,15,Jharkhand,12947659,10333954,2613705,2021-08-31 18:15:45
6527,16,Karnataka,42413133,32052761,10360372,2021-08-31 18:15:45
6528,17,Kerala,29092016,21286466,7805550,2021-08-31 18:15:45
6529,18,Ladakh,295676,193686,101990,2021-08-31 18:15:45
6530,19,Lakshadweep,76411,52598,23813,2021-08-31 18:15:45
6531,20,Madhya Pradesh,46520735,38289754,8230981,2021-08-31 18:15:45
6532,21,Maharashtra,59062278,43065734,15996544,2021-08-31 18:15:45
6533,22,Manipur,1532153,1194459,337694,2021-08-31 18:15:45
6534,23,Meghalaya,1334848,1025594,309254,2021-08-31 18:15:45
6535,24,Mizoram,907747,670273,237474,2021-08-31 18:15:45
6536,25,Nagaland,856935,655037,201898,2021-08-31 18:15:45
6537,26,Odisha,22305639,16882816,5422823,2021-08-31 18:15:45
6538,27,Puducherry,825504,639789,185715,2021-08-31 18:15:45
6539,28,Punjab,13551964,10296493,3255471,2021-08-31 18:15:45
6540,29,Rajasthan,44793680,33892331,10901349,2021-08-31 18:15:45
6541,30,Sikkim,673738,506274,167464,2021-08-31 18:15:45
6542,31,Tamil Nadu,32637600,26122651,6514949,2021-08-31 18:15:45
6543,32,Telangana,17999002,13369023,4629979,2021-08-31 18:15:45
6544,33,Tripura,3346245,2460618,885627,2021-08-31 18:15:45
6545,34,Uttar Pradesh,73132106,61430194,11701912,2021-08-31 18:15:45
6546,35,Uttarakhand,8515603,6484552,2031051,2021-08-31 18:15:45
6547,36,West Bengal,41085887,29531231,11554656,2021-08-31 18:15:45
6548,37,Daman and Diu,331286,253883,77403,2021-08-31 18:15:45
6549,1,Andaman and Nicobar Islands,365280,258906,106374,2021-09-01 18:13:32
6550,2,Andhra Pradesh,30901006,22205124,8695882,2021-09-01 18:13:32
6551,3,Arunachal Pradesh,974628,728204,246424,2021-09-01 18:13:32
6552,4,Assam,17668892,14514166,3154726,2021-09-01 18:13:32
6553,5,Bihar,38470608,32102568,6368040,2021-09-01 18:13:32
6554,6,Chandigarh,1123594,811314,312280,2021-09-01 18:13:32
6555,7,Chhattisgarh,13380617,10087725,3292892,2021-09-01 18:13:32
6556,8,Dadra and Nagar Haveli,429180,364020,65160,2021-09-01 18:13:32
6557,9,Delhi,13631650,9737352,3894298,2021-09-01 18:13:32
6558,10,Goa,1595139,1168554,426585,2021-09-01 18:13:32
6559,11,Gujarat,47112700,35136665,11976035,2021-09-01 18:13:32
6560,12,Haryana,16494372,12330196,4164176,2021-09-01 18:13:32
6561,13,Himachal Pradesh,7268513,5506058,1762455,2021-09-01 18:13:32
6562,14,Jammu and Kashmir,8198306,6324321,1873985,2021-09-01 18:13:32
6563,15,Jharkhand,13159309,10497282,2662027,2021-09-01 18:13:32
6564,16,Karnataka,43638131,32959885,10678246,2021-09-01 18:13:32
6565,17,Kerala,29280981,21402786,7878195,2021-09-01 18:13:32
6566,18,Ladakh,298154,194086,104068,2021-09-01 18:13:32
6567,19,Lakshadweep,76994,52684,24310,2021-09-01 18:13:32
6568,20,Madhya Pradesh,47270653,38838050,8432603,2021-09-01 18:13:32
6569,21,Maharashtra,60070612,43788919,16281693,2021-09-01 18:13:32
6570,22,Manipur,1541293,1196203,345090,2021-09-01 18:13:32
6571,23,Meghalaya,1338779,1027650,311129,2021-09-01 18:13:32
6572,24,Mizoram,909049,670431,238618,2021-09-01 18:13:32
6573,25,Nagaland,862288,656136,206152,2021-09-01 18:13:32
6574,26,Odisha,22599573,17080285,5519288,2021-09-01 18:13:32
6575,27,Puducherry,829623,641827,187796,2021-09-01 18:13:32
6576,28,Punjab,13763838,10455875,3307963,2021-09-01 18:13:32
6577,29,Rajasthan,45453513,34364525,11088988,2021-09-01 18:13:32
6578,30,Sikkim,674768,506495,168273,2021-09-01 18:13:32
6579,31,Tamil Nadu,33143030,26535845,6607185,2021-09-01 18:13:32
6580,32,Telangana,18064792,13406780,4658012,2021-09-01 18:13:32
6581,33,Tripura,3349995,2461354,888641,2021-09-01 18:13:32
6582,34,Uttar Pradesh,74154285,62275191,11879094,2021-09-01 18:13:32
6583,35,Uttarakhand,8599855,6545641,2054214,2021-09-01 18:13:32
6584,36,West Bengal,41608366,29899502,11708864,2021-09-01 18:13:32
6585,37,Daman and Diu,333441,254175,79266,2021-09-01 18:13:32
6586,1,Andaman and Nicobar Islands,367185,260196,106989,2021-09-02 18:22:15
6587,2,Andhra Pradesh,31035313,22279070,8756243,2021-09-02 18:22:15
6588,3,Arunachal Pradesh,979526,729359,250167,2021-09-02 18:22:15
6589,4,Assam,17897839,14691761,3206078,2021-09-02 18:22:15
6590,5,Bihar,38652124,32236696,6415428,2021-09-02 18:22:15
6591,6,Chandigarh,1131769,815595,316174,2021-09-02 18:22:15
6592,7,Chhattisgarh,13550039,10192819,3357220,2021-09-02 18:22:15
6593,8,Dadra and Nagar Haveli,431521,364786,66735,2021-09-02 18:22:15
6594,9,Delhi,13785465,9844043,3941422,2021-09-02 18:22:15
6595,10,Goa,1602579,1170547,432032,2021-09-02 18:22:15
6596,11,Gujarat,47823820,35581963,12241857,2021-09-02 18:22:15
6597,12,Haryana,16701245,12473957,4227288,2021-09-02 18:22:15
6598,13,Himachal Pradesh,7293022,5517164,1775858,2021-09-02 18:22:15
6599,14,Jammu and Kashmir,8260827,6363243,1897584,2021-09-02 18:22:15
6600,15,Jharkhand,13313997,10613940,2700057,2021-09-02 18:22:15
6601,16,Karnataka,44039006,33228270,10810736,2021-09-02 18:22:15
6602,17,Kerala,29423239,21489682,7933557,2021-09-02 18:22:15
6603,18,Ladakh,301052,194482,106570,2021-09-02 18:22:15
6604,19,Lakshadweep,77673,52734,24939,2021-09-02 18:22:15
6605,20,Madhya Pradesh,47821557,39213968,8607589,2021-09-02 18:22:15
6606,21,Maharashtra,60770790,44274588,16496202,2021-09-02 18:22:15
6607,22,Manipur,1546765,1197186,349579,2021-09-02 18:22:15
6608,23,Meghalaya,1343411,1030061,313350,2021-09-02 18:22:15
6609,24,Mizoram,912449,671357,241092,2021-09-02 18:22:15
6610,25,Nagaland,866451,657003,209448,2021-09-02 18:22:15
6611,26,Odisha,22909943,17297046,5612897,2021-09-02 18:22:15
6612,27,Puducherry,833464,643568,189896,2021-09-02 18:22:15
6613,28,Punjab,14093740,10707157,3386583,2021-09-02 18:22:15
6614,29,Rajasthan,45743670,34554568,11189102,2021-09-02 18:22:15
6615,30,Sikkim,678661,506887,171774,2021-09-02 18:22:15
6616,31,Tamil Nadu,33639238,26939571,6699667,2021-09-02 18:22:15
6617,32,Telangana,18252424,13526094,4726330,2021-09-02 18:22:15
6618,33,Tripura,3355708,2462670,893038,2021-09-02 18:22:15
6619,34,Uttar Pradesh,75802660,63675379,12127281,2021-09-02 18:22:15
6620,35,Uttarakhand,8687596,6605623,2081973,2021-09-02 18:22:15
6621,36,West Bengal,42226722,30347570,11879152,2021-09-02 18:22:15
6622,37,Daman and Diu,335848,254529,81319,2021-09-02 18:22:15
6623,1,Andaman and Nicobar Islands,368593,261094,107499,2021-09-03 18:07:09
6624,2,Andhra Pradesh,31135902,22310746,8825156,2021-09-03 18:07:09
6625,3,Arunachal Pradesh,984744,730608,254136,2021-09-03 18:07:09
6626,4,Assam,18167288,14903993,3263295,2021-09-03 18:07:09
6627,5,Bihar,38785551,32327344,6458207,2021-09-03 18:07:09
6628,6,Chandigarh,1139943,819773,320170,2021-09-03 18:07:09
6629,7,Chhattisgarh,13604630,10225816,3378814,2021-09-03 18:07:09
6630,8,Dadra and Nagar Haveli,434402,365659,68743,2021-09-03 18:07:09
6631,9,Delhi,13927370,9938162,3989208,2021-09-03 18:07:09
6632,10,Goa,1609689,1172467,437222,2021-09-03 18:07:09
6633,11,Gujarat,48316397,35908830,12407567,2021-09-03 18:07:09
6634,12,Haryana,16907624,12602193,4305431,2021-09-03 18:07:09
6635,13,Himachal Pradesh,7321469,5528705,1792764,2021-09-03 18:07:09
6636,14,Jammu and Kashmir,8314060,6397219,1916841,2021-09-03 18:07:09
6637,15,Jharkhand,13491804,10747513,2744291,2021-09-03 18:07:09
6638,16,Karnataka,44407857,33441009,10966848,2021-09-03 18:07:09
6639,17,Kerala,29543558,21564641,7978917,2021-09-03 18:07:09
6640,18,Ladakh,303801,194853,108948,2021-09-03 18:07:09
6641,19,Lakshadweep,78408,52834,25574,2021-09-03 18:07:09
6642,20,Madhya Pradesh,48000454,39330110,8670344,2021-09-03 18:07:09
6643,21,Maharashtra,61514298,44769675,16744623,2021-09-03 18:07:09
6644,22,Manipur,1554455,1198553,355902,2021-09-03 18:07:09
6645,23,Meghalaya,1349116,1032317,316799,2021-09-03 18:07:09
6646,24,Mizoram,917267,672129,245138,2021-09-03 18:07:09
6647,25,Nagaland,871965,658225,213740,2021-09-03 18:07:09
6648,26,Odisha,23288889,17560634,5728255,2021-09-03 18:07:09
6649,27,Puducherry,839108,646030,193078,2021-09-03 18:07:09
6650,28,Punjab,14239303,10813793,3425510,2021-09-03 18:07:09
6651,29,Rajasthan,45935070,34673883,11261187,2021-09-03 18:07:09
6652,30,Sikkim,686239,507525,178714,2021-09-03 18:07:09
6653,31,Tamil Nadu,34159609,27356258,6803351,2021-09-03 18:07:09
6654,32,Telangana,18424193,13624411,4799782,2021-09-03 18:07:09
6655,33,Tripura,3360758,2463828,896930,2021-09-03 18:07:09
6656,34,Uttar Pradesh,76987972,64646991,12340981,2021-09-03 18:07:09
6657,35,Uttarakhand,8776655,6665214,2111441,2021-09-03 18:07:09
6658,36,West Bengal,42777533,30733854,12043679,2021-09-03 18:07:09
6659,37,Daman and Diu,338355,254800,83555,2021-09-03 18:07:09
6660,1,Andaman and Nicobar Islands,370346,262122,108224,2021-09-04 18:07:12
6661,2,Andhra Pradesh,31262657,22353652,8909005,2021-09-04 18:07:12
6662,3,Arunachal Pradesh,989623,731891,257732,2021-09-04 18:07:12
6663,4,Assam,18421432,15099170,3322262,2021-09-04 18:07:12
6664,5,Bihar,39377567,32790518,6587049,2021-09-04 18:07:12
6665,6,Chandigarh,1150607,824569,326038,2021-09-04 18:07:12
6666,7,Chhattisgarh,13738816,10310505,3428311,2021-09-04 18:07:12
6667,8,Dadra and Nagar Haveli,437334,366382,70952,2021-09-04 18:07:12
6668,9,Delhi,14095786,10040992,4054794,2021-09-04 18:07:12
6669,10,Goa,1619122,1175258,443864,2021-09-04 18:07:12
6670,11,Gujarat,48654704,36129966,12524738,2021-09-04 18:07:12
6671,12,Haryana,17054681,12686258,4368423,2021-09-04 18:07:12
6672,13,Himachal Pradesh,7352584,5540141,1812443,2021-09-04 18:07:12
6673,14,Jammu and Kashmir,8371690,6434761,1936929,2021-09-04 18:07:12
6674,15,Jharkhand,13668689,10877129,2791560,2021-09-04 18:07:12
6675,16,Karnataka,44793856,33636265,11157591,2021-09-04 18:07:12
6676,17,Kerala,29615471,21599138,8016333,2021-09-04 18:07:12
6677,18,Ladakh,306185,195217,110968,2021-09-04 18:07:12
6678,19,Lakshadweep,78874,52884,25990,2021-09-04 18:07:12
6679,20,Madhya Pradesh,48468281,39628598,8839683,2021-09-04 18:07:12
6680,21,Maharashtra,62755027,45564551,17190476,2021-09-04 18:07:12
6681,22,Manipur,1560792,1199859,360933,2021-09-04 18:07:12
6682,23,Meghalaya,1354747,1033952,320795,2021-09-04 18:07:12
6683,24,Mizoram,918661,672993,245668,2021-09-04 18:07:12
6684,25,Nagaland,873750,658637,215113,2021-09-04 18:07:12
6685,26,Odisha,23655003,17825147,5829856,2021-09-04 18:07:12
6686,27,Puducherry,847033,649377,197656,2021-09-04 18:07:12
6687,28,Punjab,14582534,11076839,3505695,2021-09-04 18:07:12
6688,29,Rajasthan,46640726,35157579,11483147,2021-09-04 18:07:12
6689,30,Sikkim,692880,508025,184855,2021-09-04 18:07:12
6690,31,Tamil Nadu,34734334,27789337,6944997,2021-09-04 18:07:12
6691,32,Telangana,18617895,13722599,4895296,2021-09-04 18:07:12
6692,33,Tripura,3365985,2464909,901076,2021-09-04 18:07:12
6693,34,Uttar Pradesh,77507275,64754626,12752649,2021-09-04 18:07:12
6694,35,Uttarakhand,8854454,6713470,2140984,2021-09-04 18:07:12
6695,36,West Bengal,43200409,31009444,12190965,2021-09-04 18:07:12
6696,37,Daman and Diu,342898,255189,87709,2021-09-04 18:07:12
6697,1,Andaman and Nicobar Islands,370432,262193,108239,2021-09-05 18:07:09
6698,2,Andhra Pradesh,31299816,22370077,8929739,2021-09-05 18:07:09
6699,3,Arunachal Pradesh,991128,732272,258856,2021-09-05 18:07:09
6700,4,Assam,18511731,15168597,3343134,2021-09-05 18:07:09
6701,5,Bihar,39539566,32917846,6621720,2021-09-05 18:07:09
6702,6,Chandigarh,1156172,827452,328720,2021-09-05 18:07:09
6703,7,Chhattisgarh,13793480,10342406,3451074,2021-09-05 18:07:09
6704,8,Dadra and Nagar Haveli,437938,366538,71400,2021-09-05 18:07:09
6705,9,Delhi,14104300,10043334,4060966,2021-09-05 18:07:09
6706,10,Goa,1626480,1176591,449889,2021-09-05 18:07:09
6707,11,Gujarat,49145955,36388715,12757240,2021-09-05 18:07:09
6708,12,Haryana,17119086,12727738,4391348,2021-09-05 18:07:09
6709,13,Himachal Pradesh,7359684,5543504,1816180,2021-09-05 18:07:09
6710,14,Jammu and Kashmir,8395414,6451032,1944382,2021-09-05 18:07:09
6711,15,Jharkhand,13870375,11028051,2842324,2021-09-05 18:07:09
6712,16,Karnataka,45000045,33749403,11250642,2021-09-05 18:07:09
6713,17,Kerala,29636101,21608979,8027122,2021-09-05 18:07:09
6714,18,Ladakh,306242,195221,111021,2021-09-05 18:07:09
6715,19,Lakshadweep,79074,52921,26153,2021-09-05 18:07:09
6716,20,Madhya Pradesh,48630259,39737793,8892466,2021-09-05 18:07:09
6717,21,Maharashtra,62950844,45687420,17263424,2021-09-05 18:07:09
6718,22,Manipur,1562413,1200546,361867,2021-09-05 18:07:09
6719,23,Meghalaya,1354948,1033993,320955,2021-09-05 18:07:09
6720,24,Mizoram,918836,673147,245689,2021-09-05 18:07:09
6721,25,Nagaland,875287,659112,216175,2021-09-05 18:07:09
6722,26,Odisha,23731424,17881234,5850190,2021-09-05 18:07:09
6723,27,Puducherry,848555,649927,198628,2021-09-05 18:07:09
6724,28,Punjab,14824469,11232618,3591851,2021-09-05 18:07:09
6725,29,Rajasthan,46805516,35269067,11536449,2021-09-05 18:07:09
6726,30,Sikkim,692891,508026,184865,2021-09-05 18:07:09
6727,31,Tamil Nadu,35093751,28066476,7027275,2021-09-05 18:07:09
6728,32,Telangana,18667980,13742156,4925824,2021-09-05 18:07:09
6729,33,Tripura,3366180,2465033,901147,2021-09-05 18:07:09
6730,34,Uttar Pradesh,77534008,64767336,12766672,2021-09-05 18:07:09
6731,35,Uttarakhand,8910735,6749270,2161465,2021-09-05 18:07:09
6732,36,West Bengal,43391432,31131268,12260164,2021-09-05 18:07:09
6733,37,Daman and Diu,342898,255189,87709,2021-09-05 18:07:09
6734,1,Andaman and Nicobar Islands,372283,263057,109226,2021-09-06 18:24:48
6735,2,Andhra Pradesh,32021953,22672793,9349160,2021-09-06 18:24:48
6736,3,Arunachal Pradesh,997760,733755,264005,2021-09-06 18:24:48
6737,4,Assam,18795507,15392517,3402990,2021-09-06 18:24:48
6738,5,Bihar,41264994,34233153,7031841,2021-09-06 18:24:48
6739,6,Chandigarh,1164624,831673,332951,2021-09-06 18:24:48
6740,7,Chhattisgarh,13884497,10395375,3489122,2021-09-06 18:24:48
6741,8,Dadra and Nagar Haveli,440951,367445,73506,2021-09-06 18:24:48
6742,9,Delhi,14267090,10149898,4117192,2021-09-06 18:24:48
6743,10,Goa,1636133,1178673,457460,2021-09-06 18:24:48
6744,11,Gujarat,49773382,36753678,13019704,2021-09-06 18:24:48
6745,12,Haryana,17245814,12810245,4435569,2021-09-06 18:24:48
6746,13,Himachal Pradesh,7377840,5550531,1827309,2021-09-06 18:24:48
6747,14,Jammu and Kashmir,8474005,6496921,1977084,2021-09-06 18:24:48
6748,15,Jharkhand,14087755,11193883,2893872,2021-09-06 18:24:48
6749,16,Karnataka,45656192,34165044,11491148,2021-09-06 18:24:48
6750,17,Kerala,29659539,21616736,8042803,2021-09-06 18:24:48
6751,18,Ladakh,308559,195704,112855,2021-09-06 18:24:48
6752,19,Lakshadweep,79946,53029,26917,2021-09-06 18:24:48
6753,20,Madhya Pradesh,49238115,40148672,9089443,2021-09-06 18:24:48
6754,21,Maharashtra,63488089,46033001,17455088,2021-09-06 18:24:48
6755,22,Manipur,1570244,1201992,368252,2021-09-06 18:24:48
6756,23,Meghalaya,1362809,1036421,326388,2021-09-06 18:24:48
6757,24,Mizoram,927432,674017,253415,2021-09-06 18:24:48
6758,25,Nagaland,884123,660683,223440,2021-09-06 18:24:48
6759,26,Odisha,24066746,18133380,5933366,2021-09-06 18:24:48
6760,27,Puducherry,852987,651535,201452,2021-09-06 18:24:48
6761,28,Punjab,14976957,11348037,3628920,2021-09-06 18:24:48
6762,29,Rajasthan,47041155,35425639,11615516,2021-09-06 18:24:48
6763,30,Sikkim,702365,508844,193521,2021-09-06 18:24:48
6764,31,Tamil Nadu,35563936,28420243,7143693,2021-09-06 18:24:48
6765,32,Telangana,18855540,13853437,5002103,2021-09-06 18:24:48
6766,33,Tripura,3372483,2466267,906216,2021-09-06 18:24:48
6767,34,Uttar Pradesh,80840083,67639929,13200154,2021-09-06 18:24:48
6768,35,Uttarakhand,8988473,6794255,2194218,2021-09-06 18:24:48
6769,36,West Bengal,44098451,31622992,12475459,2021-09-06 18:24:48
6770,37,Daman and Diu,345628,255487,90141,2021-09-06 18:24:48
6771,1,Andaman and Nicobar Islands,374322,264208,110114,2021-09-07 18:24:35
6772,2,Andhra Pradesh,32204576,22755870,9448706,2021-09-07 18:24:35
6773,3,Arunachal Pradesh,1002119,734660,267459,2021-09-07 18:24:35
6774,4,Assam,19091441,15629298,3462143,2021-09-07 18:24:35
6775,5,Bihar,42203051,34950502,7252549,2021-09-07 18:24:35
6776,6,Chandigarh,1172616,835465,337151,2021-09-07 18:24:35
6777,7,Chhattisgarh,13971845,10448515,3523330,2021-09-07 18:24:35
6778,8,Dadra and Nagar Haveli,443493,368162,75331,2021-09-07 18:24:35
6779,9,Delhi,14440163,10264799,4175364,2021-09-07 18:24:35
6780,10,Goa,1645283,1180115,465168,2021-09-07 18:24:35
6781,11,Gujarat,50323340,37077895,13245445,2021-09-07 18:24:35
6782,12,Haryana,17422617,12929609,4493008,2021-09-07 18:24:35
6783,13,Himachal Pradesh,7400811,5556903,1843908,2021-09-07 18:24:35
6784,14,Jammu and Kashmir,8625091,6574301,2050790,2021-09-07 18:24:35
6785,15,Jharkhand,14281604,11340646,2940958,2021-09-07 18:24:35
6786,16,Karnataka,46097571,34435476,11662095,2021-09-07 18:24:35
6787,17,Kerala,30433836,22057942,8375894,2021-09-07 18:24:35
6788,18,Ladakh,310684,196133,114551,2021-09-07 18:24:35
6789,19,Lakshadweep,80578,53085,27493,2021-09-07 18:24:35
6790,20,Madhya Pradesh,49518445,40341721,9176724,2021-09-07 18:24:35
6791,21,Maharashtra,64077326,46431798,17645528,2021-09-07 18:24:35
6792,22,Manipur,1576608,1203494,373114,2021-09-07 18:24:35
6793,23,Meghalaya,1370348,1038781,331567,2021-09-07 18:24:35
6794,24,Mizoram,941126,675308,265818,2021-09-07 18:24:35
6795,25,Nagaland,893306,662455,230851,2021-09-07 18:24:35
6796,26,Odisha,24359517,18352643,6006874,2021-09-07 18:24:35
6797,27,Puducherry,856311,652621,203690,2021-09-07 18:24:35
6798,28,Punjab,15087536,11428003,3659533,2021-09-07 18:24:35
6799,29,Rajasthan,47354626,35608701,11745925,2021-09-07 18:24:35
6800,30,Sikkim,711340,509360,201980,2021-09-07 18:24:35
6801,31,Tamil Nadu,36009137,28759475,7249662,2021-09-07 18:24:35
6802,32,Telangana,19012996,13940536,5072460,2021-09-07 18:24:35
6803,33,Tripura,3380436,2467496,912940,2021-09-07 18:24:35
6804,34,Uttar Pradesh,82469560,68992714,13476846,2021-09-07 18:24:35
6805,35,Uttarakhand,9061210,6835380,2225830,2021-09-07 18:24:35
6806,36,West Bengal,44678618,32021183,12657435,2021-09-07 18:24:35
6807,37,Daman and Diu,348004,255860,92144,2021-09-07 18:24:35
6808,1,Andaman and Nicobar Islands,376424,265487,110937,2021-09-08 18:26:44
6809,2,Andhra Pradesh,32257648,22780082,9477566,2021-09-08 18:26:44
6810,3,Arunachal Pradesh,1008168,735776,272392,2021-09-08 18:26:44
6811,4,Assam,19257438,15755445,3501993,2021-09-08 18:26:44
6812,5,Bihar,42906958,35523271,7383687,2021-09-08 18:26:44
6813,6,Chandigarh,1180020,838762,341258,2021-09-08 18:26:44
6814,7,Chhattisgarh,14109243,10532493,3576750,2021-09-08 18:26:44
6815,8,Dadra and Nagar Haveli,445049,368594,76455,2021-09-08 18:26:44
6816,9,Delhi,14585577,10361911,4223666,2021-09-08 18:26:44
6817,10,Goa,1653475,1181518,471957,2021-09-08 18:26:44
6818,11,Gujarat,50866294,37384989,13481305,2021-09-08 18:26:44
6819,12,Haryana,17605960,13054705,4551255,2021-09-08 18:26:44
6820,13,Himachal Pradesh,7424999,5562998,1862001,2021-09-08 18:26:44
6821,14,Jammu and Kashmir,8769401,6628955,2140446,2021-09-08 18:26:44
6822,15,Jharkhand,14429735,11451701,2978034,2021-09-08 18:26:44
6823,16,Karnataka,46849417,34899170,11950247,2021-09-08 18:26:44
6824,17,Kerala,30664212,22182803,8481409,2021-09-08 18:26:44
6825,18,Ladakh,312550,196554,115996,2021-09-08 18:26:44
6826,19,Lakshadweep,81790,53191,28599,2021-09-08 18:26:44
6827,20,Madhya Pradesh,50153498,40756249,9397249,2021-09-08 18:26:44
6828,21,Maharashtra,65573078,47588021,17985057,2021-09-08 18:26:44
6829,22,Manipur,1582499,1204611,377888,2021-09-08 18:26:44
6830,23,Meghalaya,1377903,1040707,337196,2021-09-08 18:26:44
6831,24,Mizoram,950774,675903,274871,2021-09-08 18:26:44
6832,25,Nagaland,902625,664233,238392,2021-09-08 18:26:44
6833,26,Odisha,24643403,18554533,6088870,2021-09-08 18:26:44
6834,27,Puducherry,859769,653787,205982,2021-09-08 18:26:44
6835,28,Punjab,15345311,11634174,3711137,2021-09-08 18:26:44
6836,29,Rajasthan,48194123,36181734,12012389,2021-09-08 18:26:44
6837,30,Sikkim,722283,509903,212380,2021-09-08 18:26:44
6838,31,Tamil Nadu,36340958,29001259,7339699,2021-09-08 18:26:44
6839,32,Telangana,19074933,13972484,5102449,2021-09-08 18:26:44
6840,33,Tripura,3384466,2468096,916370,2021-09-08 18:26:44
6841,34,Uttar Pradesh,83479381,69810486,13668895,2021-09-08 18:26:44
6842,35,Uttarakhand,9128744,6874796,2253948,2021-09-08 18:26:44
6843,36,West Bengal,45370192,32515329,12854863,2021-09-08 18:26:44
6844,37,Daman and Diu,349985,256185,93800,2021-09-08 18:26:44
6845,1,Andaman and Nicobar Islands,379203,267089,112114,2021-09-09 18:07:08
6846,2,Andhra Pradesh,32294173,22795617,9498556,2021-09-09 18:07:08
6847,3,Arunachal Pradesh,1014307,736763,277544,2021-09-09 18:07:08
6848,4,Assam,19545881,15985205,3560676,2021-09-09 18:07:08
6849,5,Bihar,43117255,35687582,7429673,2021-09-09 18:07:08
6850,6,Chandigarh,1187068,841936,345132,2021-09-09 18:07:08
6851,7,Chhattisgarh,14145988,10552913,3593075,2021-09-09 18:07:08
6852,8,Dadra and Nagar Haveli,447496,369177,78319,2021-09-09 18:07:08
6853,9,Delhi,14739108,10463138,4275970,2021-09-09 18:07:08
6854,10,Goa,1661678,1183247,478431,2021-09-09 18:07:08
6855,11,Gujarat,51436786,37702165,13734621,2021-09-09 18:07:08
6856,12,Haryana,17869587,13244764,4624823,2021-09-09 18:07:08
6857,13,Himachal Pradesh,7450927,5568613,1882314,2021-09-09 18:07:08
6858,14,Jammu and Kashmir,8940590,6688135,2252455,2021-09-09 18:07:08
6859,15,Jharkhand,14533150,11527984,3005166,2021-09-09 18:07:08
6860,16,Karnataka,47089658,35030584,12059074,2021-09-09 18:07:08
6861,17,Kerala,30767695,22233686,8534009,2021-09-09 18:07:08
6862,18,Ladakh,314322,197077,117245,2021-09-09 18:07:08
6863,19,Lakshadweep,82803,53308,29495,2021-09-09 18:07:08
6864,20,Madhya Pradesh,50617791,41081442,9536349,2021-09-09 18:07:08
6865,21,Maharashtra,66592481,48330198,18262283,2021-09-09 18:07:08
6866,22,Manipur,1585809,1205563,380246,2021-09-09 18:07:08
6867,23,Meghalaya,1386862,1042840,344022,2021-09-09 18:07:08
6868,24,Mizoram,963534,677321,286213,2021-09-09 18:07:08
6869,25,Nagaland,910273,665382,244891,2021-09-09 18:07:08
6870,26,Odisha,24997328,18810049,6187279,2021-09-09 18:07:08
6871,27,Puducherry,862922,654692,208230,2021-09-09 18:07:08
6872,28,Punjab,15690658,11902511,3788147,2021-09-09 18:07:08
6873,29,Rajasthan,48663412,36479359,12184053,2021-09-09 18:07:08
6874,30,Sikkim,725031,510045,214986,2021-09-09 18:07:08
6875,31,Tamil Nadu,36659943,29227349,7432594,2021-09-09 18:07:08
6876,32,Telangana,19284498,14101624,5182874,2021-09-09 18:07:08
6877,33,Tripura,3396998,2469699,927299,2021-09-09 18:07:08
6878,34,Uttar Pradesh,84714740,70821428,13893312,2021-09-09 18:07:08
6879,35,Uttarakhand,9196461,6915009,2281452,2021-09-09 18:07:08
6880,36,West Bengal,45887034,32866691,13020343,2021-09-09 18:07:08
6881,37,Daman and Diu,352886,256647,96239,2021-09-09 18:07:08
6882,1,Andaman and Nicobar Islands,381067,268265,112802,2021-09-10 18:07:12
6883,2,Andhra Pradesh,32306806,22800818,9505988,2021-09-10 18:07:12
6884,3,Arunachal Pradesh,1020751,737711,283040,2021-09-10 18:07:12
6885,4,Assam,19826525,16206112,3620413,2021-09-10 18:07:12
6886,5,Bihar,43589324,36046394,7542930,2021-09-10 18:07:12
6887,6,Chandigarh,1195067,845085,349982,2021-09-10 18:07:12
6888,7,Chhattisgarh,14191598,10578117,3613481,2021-09-10 18:07:12
6889,8,Dadra and Nagar Haveli,449079,369573,79506,2021-09-10 18:07:12
6890,9,Delhi,14880804,10554086,4326718,2021-09-10 18:07:12
6891,10,Goa,1661679,1183247,478432,2021-09-10 18:07:12
6892,11,Gujarat,51928154,37975502,13952652,2021-09-10 18:07:12
6893,12,Haryana,18087051,13398451,4688600,2021-09-10 18:07:12
6894,13,Himachal Pradesh,7480151,5574225,1905926,2021-09-10 18:07:12
6895,14,Jammu and Kashmir,9100480,6738198,2362282,2021-09-10 18:07:12
6896,15,Jharkhand,14692013,11641499,3050514,2021-09-10 18:07:12
6897,16,Karnataka,47153693,35061495,12092198,2021-09-10 18:07:12
6898,17,Kerala,31432587,22635020,8797567,2021-09-10 18:07:12
6899,18,Ladakh,315980,197492,118488,2021-09-10 18:07:12
6900,19,Lakshadweep,83654,53365,30289,2021-09-10 18:07:12
6901,20,Madhya Pradesh,50918772,41305057,9613715,2021-09-10 18:07:12
6902,21,Maharashtra,66715446,48414405,18301041,2021-09-10 18:07:12
6903,22,Manipur,1591823,1206722,385101,2021-09-10 18:07:12
6904,23,Meghalaya,1397154,1045387,351767,2021-09-10 18:07:12
6905,24,Mizoram,973259,678242,295017,2021-09-10 18:07:12
6906,25,Nagaland,918546,666906,251640,2021-09-10 18:07:12
6907,26,Odisha,25147876,18916381,6231495,2021-09-10 18:07:12
6908,27,Puducherry,864358,654998,209360,2021-09-10 18:07:12
6909,28,Punjab,15876388,12048496,3827892,2021-09-10 18:07:12
6910,29,Rajasthan,49434931,36989200,12445731,2021-09-10 18:07:12
6911,30,Sikkim,740460,510757,229703,2021-09-10 18:07:12
6912,31,Tamil Nadu,36819549,29336321,7483228,2021-09-10 18:07:12
6913,32,Telangana,19292705,14105262,5187443,2021-09-10 18:07:12
6914,33,Tripura,3406505,2470655,935850,2021-09-10 18:07:12
6915,34,Uttar Pradesh,86230062,72061918,14168144,2021-09-10 18:07:12
6916,35,Uttarakhand,9263574,6953864,2309710,2021-09-10 18:07:12
6917,36,West Bengal,46608643,33376274,13232369,2021-09-10 18:07:12
6918,37,Daman and Diu,352886,256647,96239,2021-09-10 18:07:12
6919,1,Andaman and Nicobar Islands,383381,269503,113878,2021-09-11 18:24:54
6920,2,Andhra Pradesh,33180367,23264305,9916062,2021-09-11 18:24:54
6921,3,Arunachal Pradesh,1026111,738584,287527,2021-09-11 18:24:54
6922,4,Assam,20077719,16396092,3681627,2021-09-11 18:24:54
6923,5,Bihar,44490433,36727398,7763035,2021-09-11 18:24:54
6924,6,Chandigarh,1206072,849234,356838,2021-09-11 18:24:54
6925,7,Chhattisgarh,14305284,10647420,3657864,2021-09-11 18:24:54
6926,8,Dadra and Nagar Haveli,451596,370115,81481,2021-09-11 18:24:54
6927,9,Delhi,15010817,10632504,4378313,2021-09-11 18:24:54
6928,10,Goa,1661795,1183270,478525,2021-09-11 18:24:54
6929,11,Gujarat,52284695,38159818,14124877,2021-09-11 18:24:54
6930,12,Haryana,18219693,13484386,4735307,2021-09-11 18:24:54
6931,13,Himachal Pradesh,7506815,5578363,1928452,2021-09-11 18:24:54
6932,14,Jammu and Kashmir,9242738,6800640,2442098,2021-09-11 18:24:54
6933,15,Jharkhand,14859687,11757923,3101764,2021-09-11 18:24:54
6934,16,Karnataka,47444744,35195416,12249328,2021-09-11 18:24:54
6935,17,Kerala,31676049,22737474,8938575,2021-09-11 18:24:54
6936,18,Ladakh,317430,197819,119611,2021-09-11 18:24:54
6937,19,Lakshadweep,85190,53572,31618,2021-09-11 18:24:54
6938,20,Madhya Pradesh,51440318,41673428,9766890,2021-09-11 18:24:54
6939,21,Maharashtra,67687444,49123029,18564415,2021-09-11 18:24:54
6940,22,Manipur,1595028,1207329,387699,2021-09-11 18:24:54
6941,23,Meghalaya,1405233,1046619,358614,2021-09-11 18:24:54
6942,24,Mizoram,975763,678503,297260,2021-09-11 18:24:54
6943,25,Nagaland,920898,667261,253637,2021-09-11 18:24:54
6944,26,Odisha,25392861,19093628,6299233,2021-09-11 18:24:54
6945,27,Puducherry,871859,656763,215096,2021-09-11 18:24:54
6946,28,Punjab,16076727,12194976,3881751,2021-09-11 18:24:54
6947,29,Rajasthan,49705194,37147897,12557297,2021-09-11 18:24:54
6948,30,Sikkim,743929,510958,232971,2021-09-11 18:24:54
6949,31,Tamil Nadu,37031882,29463542,7568340,2021-09-11 18:24:54
6950,32,Telangana,19505921,14212422,5293499,2021-09-11 18:24:54
6951,33,Tripura,3422221,2471951,950270,2021-09-11 18:24:54
6952,34,Uttar Pradesh,86883220,72238841,14644379,2021-09-11 18:24:54
6953,35,Uttarakhand,9332926,6990744,2342182,2021-09-11 18:24:54
6954,36,West Bengal,47171608,33749357,13422251,2021-09-11 18:24:54
6955,37,Daman and Diu,356805,257135,99670,2021-09-11 18:24:54
6956,1,Andaman and Nicobar Islands,385765,271358,114407,2021-09-12 18:15:14
6957,2,Andhra Pradesh,34730996,24072522,10658474,2021-09-12 18:15:14
6958,3,Arunachal Pradesh,1027023,738725,288298,2021-09-12 18:15:14
6959,4,Assam,20154527,16454439,3700088,2021-09-12 18:15:14
6960,5,Bihar,44809283,36949899,7859384,2021-09-12 18:15:14
6961,6,Chandigarh,1210289,851067,359222,2021-09-12 18:15:14
6962,7,Chhattisgarh,14377048,10692420,3684628,2021-09-12 18:15:14
6963,8,Dadra and Nagar Haveli,452086,370221,81865,2021-09-12 18:15:14
6964,9,Delhi,15022690,10637851,4384839,2021-09-12 18:15:14
6965,10,Goa,1668823,1184536,484287,2021-09-12 18:15:14
6966,11,Gujarat,52443607,38248743,14194864,2021-09-12 18:15:14
6967,12,Haryana,18303769,13546897,4756872,2021-09-12 18:15:14
6968,13,Himachal Pradesh,7507558,5578530,1929028,2021-09-12 18:15:14
6969,14,Jammu and Kashmir,9332086,6841269,2490817,2021-09-12 18:15:14
6970,15,Jharkhand,15029995,11876067,3153928,2021-09-12 18:15:14
6971,16,Karnataka,47528707,35233074,12295633,2021-09-12 18:15:14
6972,17,Kerala,31718434,22755174,8963260,2021-09-12 18:15:14
6973,18,Ladakh,317430,197819,119611,2021-09-12 18:15:14
6974,19,Lakshadweep,86806,53750,33056,2021-09-12 18:15:14
6975,20,Madhya Pradesh,51650787,41826410,9824377,2021-09-12 18:15:14
6976,21,Maharashtra,67890356,49256169,18634187,2021-09-12 18:15:14
6977,22,Manipur,1595744,1207523,388221,2021-09-12 18:15:14
6978,23,Meghalaya,1405701,1046691,359010,2021-09-12 18:15:14
6979,24,Mizoram,975763,678503,297260,2021-09-12 18:15:14
6980,25,Nagaland,923658,667893,255765,2021-09-12 18:15:14
6981,26,Odisha,25438498,19124125,6314373,2021-09-12 18:15:14
6982,27,Puducherry,873986,657273,216713,2021-09-12 18:15:14
6983,28,Punjab,16169980,12257228,3912752,2021-09-12 18:15:14
6984,29,Rajasthan,49802182,37204129,12598053,2021-09-12 18:15:14
6985,30,Sikkim,744248,510967,233281,2021-09-12 18:15:14
6986,31,Tamil Nadu,39072372,31083074,7989298,2021-09-12 18:15:14
6987,32,Telangana,19535877,14225349,5310528,2021-09-12 18:15:14
6988,33,Tripura,3422746,2472024,950722,2021-09-12 18:15:14
6989,34,Uttar Pradesh,86917224,72257363,14659861,2021-09-12 18:15:14
6990,35,Uttarakhand,9368180,7010378,2357802,2021-09-12 18:15:14
6991,36,West Bengal,47337516,33873754,13463762,2021-09-12 18:15:14
6992,37,Daman and Diu,356870,257137,99733,2021-09-12 18:15:14
6993,1,Andaman and Nicobar Islands,388227,272995,115232,2021-09-13 18:25:15
6994,2,Andhra Pradesh,35183392,24329287,10854105,2021-09-13 18:25:15
6995,3,Arunachal Pradesh,1037009,740049,296960,2021-09-13 18:25:15
6996,4,Assam,20438662,16645259,3793403,2021-09-13 18:25:15
6997,5,Bihar,45665487,37603892,8061595,2021-09-13 18:25:15
6998,6,Chandigarh,1219770,854773,364997,2021-09-13 18:25:15
6999,7,Chhattisgarh,14519298,10780229,3739069,2021-09-13 18:25:15
7000,8,Dadra and Nagar Haveli,454130,370615,83515,2021-09-13 18:25:15
7001,9,Delhi,15187630,10741516,4446114,2021-09-13 18:25:15
7002,10,Goa,1678942,1186557,492385,2021-09-13 18:25:15
7003,11,Gujarat,52589811,38326342,14263469,2021-09-13 18:25:15
7004,12,Haryana,18844735,13920149,4924586,2021-09-13 18:25:15
7005,13,Himachal Pradesh,7552902,5585654,1967248,2021-09-13 18:25:15
7006,14,Jammu and Kashmir,9455059,6904637,2550422,2021-09-13 18:25:15
7007,15,Jharkhand,15216812,12003770,3213042,2021-09-13 18:25:15
7008,16,Karnataka,47896723,35401305,12495418,2021-09-13 18:25:15
7009,17,Kerala,31833256,22804284,9028972,2021-09-13 18:25:15
7010,18,Ladakh,319682,198198,121484,2021-09-13 18:25:15
7011,19,Lakshadweep,87842,53893,33949,2021-09-13 18:25:15
7012,20,Madhya Pradesh,51985643,42042261,9943382,2021-09-13 18:25:15
7013,21,Maharashtra,68370087,49579708,18790379,2021-09-13 18:25:15
7014,22,Manipur,1601610,1208708,392902,2021-09-13 18:25:15
7015,23,Meghalaya,1416069,1048445,367624,2021-09-13 18:25:15
7016,24,Mizoram,986006,679460,306546,2021-09-13 18:25:15
7017,25,Nagaland,933195,669447,263748,2021-09-13 18:25:15
7018,26,Odisha,25732915,19317457,6415458,2021-09-13 18:25:15
7019,27,Puducherry,881187,659323,221864,2021-09-13 18:25:15
7020,28,Punjab,16402885,12427985,3974900,2021-09-13 18:25:15
7021,29,Rajasthan,50203653,37448045,12755608,2021-09-13 18:25:15
7022,30,Sikkim,761001,511851,249150,2021-09-13 18:25:15
7023,31,Tamil Nadu,39695395,31570284,8125111,2021-09-13 18:25:15
7024,32,Telangana,19771267,14362503,5408764,2021-09-13 18:25:15
7025,33,Tripura,3469406,2474855,994551,2021-09-13 18:25:15
7026,34,Uttar Pradesh,88630182,73661434,14968748,2021-09-13 18:25:15
7027,35,Uttarakhand,9435086,7041295,2393791,2021-09-13 18:25:15
7028,36,West Bengal,47771923,34148997,13622926,2021-09-13 18:25:15
7029,37,Daman and Diu,359200,257443,101757,2021-09-13 18:25:15
7030,1,Andaman and Nicobar Islands,392113,274979,117134,2021-09-14 18:21:09
7031,2,Andhra Pradesh,35372330,24439926,10932404,2021-09-14 18:21:09
7032,3,Arunachal Pradesh,1044281,741048,303233,2021-09-14 18:21:09
7033,4,Assam,20641178,16772676,3868502,2021-09-14 18:21:09
7034,5,Bihar,46114388,37925252,8189136,2021-09-14 18:21:09
7035,6,Chandigarh,1228457,858219,370238,2021-09-14 18:21:09
7036,7,Chhattisgarh,14597896,10825590,3772306,2021-09-14 18:21:09
7037,8,Dadra and Nagar Haveli,456724,371118,85606,2021-09-14 18:21:09
7038,9,Delhi,15352867,10843365,4509502,2021-09-14 18:21:09
7039,10,Goa,1688504,1188393,500111,2021-09-14 18:21:09
7040,11,Gujarat,52985686,38503014,14482672,2021-09-14 18:21:09
7041,12,Haryana,19217179,14183208,5033971,2021-09-14 18:21:09
7042,13,Himachal Pradesh,7604412,5592174,2012238,2021-09-14 18:21:09
7043,14,Jammu and Kashmir,9552657,6954043,2598614,2021-09-14 18:21:09
7044,15,Jharkhand,15372414,12110607,3261807,2021-09-14 18:21:09
7045,16,Karnataka,48215192,35543403,12671789,2021-09-14 18:21:09
7046,17,Kerala,31874863,22820484,9054379,2021-09-14 18:21:09
7047,18,Ladakh,321823,198645,123178,2021-09-14 18:21:09
7048,19,Lakshadweep,88720,53956,34764,2021-09-14 18:21:09
7049,20,Madhya Pradesh,52179133,42164107,10015026,2021-09-14 18:21:09
7050,21,Maharashtra,68898524,49916414,18982110,2021-09-14 18:21:09
7051,22,Manipur,1607089,1210078,397011,2021-09-14 18:21:09
7052,23,Meghalaya,1425583,1050737,374846,2021-09-14 18:21:09
7053,24,Mizoram,1000697,680500,320197,2021-09-14 18:21:09
7054,25,Nagaland,942168,671315,270853,2021-09-14 18:21:09
7055,26,Odisha,26054619,19511271,6543348,2021-09-14 18:21:09
7056,27,Puducherry,886913,660745,226168,2021-09-14 18:21:09
7057,28,Punjab,16550233,12530142,4020091,2021-09-14 18:21:09
7058,29,Rajasthan,50713820,37744466,12969354,2021-09-14 18:21:09
7059,30,Sikkim,776031,512478,263553,2021-09-14 18:21:09
7060,31,Tamil Nadu,40198734,31930380,8268354,2021-09-14 18:21:09
7061,32,Telangana,20001396,14494759,5506637,2021-09-14 18:21:09
7062,33,Tripura,3532072,2477918,1054154,2021-09-14 18:21:09
7063,34,Uttar Pradesh,89766746,74531443,15235303,2021-09-14 18:21:09
7064,35,Uttarakhand,9504699,7070125,2434574,2021-09-14 18:21:09
7065,36,West Bengal,48127154,34371142,13756012,2021-09-14 18:21:09
7066,37,Daman and Diu,361355,257770,103585,2021-09-14 18:21:09
7067,1,Andaman and Nicobar Islands,397695,278249,119446,2021-09-15 18:21:33
7068,2,Andhra Pradesh,35493483,24503468,10990015,2021-09-15 18:21:33
7069,3,Arunachal Pradesh,1052766,741943,310823,2021-09-15 18:21:33
7070,4,Assam,20742931,16830668,3912263,2021-09-15 18:21:33
7071,5,Bihar,46280966,38034434,8246532,2021-09-15 18:21:33
7072,6,Chandigarh,1236804,861602,375202,2021-09-15 18:21:33
7073,7,Chhattisgarh,14715923,10891691,3824232,2021-09-15 18:21:33
7074,8,Dadra and Nagar Haveli,459220,371658,87562,2021-09-15 18:21:33
7075,9,Delhi,15490720,10926460,4564260,2021-09-15 18:21:33
7076,10,Goa,1698762,1190188,508574,2021-09-15 18:21:33
7077,11,Gujarat,53346407,38658314,14688093,2021-09-15 18:21:33
7078,12,Haryana,19825791,14621417,5204374,2021-09-15 18:21:33
7079,13,Himachal Pradesh,7655521,5597639,2057882,2021-09-15 18:21:33
7080,14,Jammu and Kashmir,9649540,6998132,2651408,2021-09-15 18:21:33
7081,15,Jharkhand,15516435,12207588,3308847,2021-09-15 18:21:33
7082,16,Karnataka,48402580,35623253,12779327,2021-09-15 18:21:33
7083,17,Kerala,32364281,23089720,9274561,2021-09-15 18:21:33
7084,18,Ladakh,323636,199036,124600,2021-09-15 18:21:33
7085,19,Lakshadweep,89430,54019,35411,2021-09-15 18:21:33
7086,20,Madhya Pradesh,52955565,42633013,10322552,2021-09-15 18:21:33
7087,21,Maharashtra,69976276,50627411,19348865,2021-09-15 18:21:33
7088,22,Manipur,1612933,1211651,401282,2021-09-15 18:21:33
7089,23,Meghalaya,1434285,1052604,381681,2021-09-15 18:21:33
7090,24,Mizoram,1017393,681705,335688,2021-09-15 18:21:33
7091,25,Nagaland,950967,672481,278486,2021-09-15 18:21:33
7092,26,Odisha,26393030,19714045,6678985,2021-09-15 18:21:33
7093,27,Puducherry,893287,662537,230750,2021-09-15 18:21:33
7094,28,Punjab,16609736,12569781,4039955,2021-09-15 18:21:33
7095,29,Rajasthan,51209112,38039216,13169896,2021-09-15 18:21:33
7096,30,Sikkim,787858,512997,274861,2021-09-15 18:21:33
7097,31,Tamil Nadu,40571993,32191243,8380750,2021-09-15 18:21:33
7098,32,Telangana,20065173,14525381,5539792,2021-09-15 18:21:33
7099,33,Tripura,3595423,2480894,1114529,2021-09-15 18:21:33
7100,34,Uttar Pradesh,90176693,74811144,15365549,2021-09-15 18:21:33
7101,35,Uttarakhand,9571807,7094939,2476868,2021-09-15 18:21:33
7102,36,West Bengal,48529020,34561938,13967082,2021-09-15 18:21:33
7103,37,Daman and Diu,364188,258185,106003,2021-09-15 18:21:33
7104,1,Andaman and Nicobar Islands,401664,279626,122038,2021-09-16 18:21:16
7105,2,Andhra Pradesh,35711140,24619702,11091438,2021-09-16 18:21:16
7106,3,Arunachal Pradesh,1060166,742800,317366,2021-09-16 18:21:16
7107,4,Assam,20909283,16936427,3972856,2021-09-16 18:21:16
7108,5,Bihar,46386638,38087955,8298683,2021-09-16 18:21:16
7109,6,Chandigarh,1244973,865083,379890,2021-09-16 18:21:16
7110,7,Chhattisgarh,14937934,11021736,3916198,2021-09-16 18:21:16
7111,8,Dadra and Nagar Haveli,462640,372320,90320,2021-09-16 18:21:16
7112,9,Delhi,15626891,11004286,4622605,2021-09-16 18:21:16
7113,10,Goa,1710966,1192294,518672,2021-09-16 18:21:16
7114,11,Gujarat,53604030,38761127,14842903,2021-09-16 18:21:16
7115,12,Haryana,20137100,14851679,5285421,2021-09-16 18:21:16
7116,13,Himachal Pradesh,7689866,5601479,2088387,2021-09-16 18:21:16
7117,14,Jammu and Kashmir,9772658,7059399,2713259,2021-09-16 18:21:16
7118,15,Jharkhand,15657270,12299953,3357317,2021-09-16 18:21:16
7119,16,Karnataka,48487473,35654970,12832503,2021-09-16 18:21:16
7120,17,Kerala,32903316,23402285,9501031,2021-09-16 18:21:16
7121,18,Ladakh,326116,199869,126247,2021-09-16 18:21:16
7122,19,Lakshadweep,90228,54130,36098,2021-09-16 18:21:16
7123,20,Madhya Pradesh,53650430,43025963,10624467,2021-09-16 18:21:16
7124,21,Maharashtra,70651360,51029263,19622097,2021-09-16 18:21:16
7125,22,Manipur,1616526,1212535,403991,2021-09-16 18:21:16
7126,23,Meghalaya,1443859,1054668,389191,2021-09-16 18:21:16
7127,24,Mizoram,1029245,682691,346554,2021-09-16 18:21:16
7128,25,Nagaland,957255,673230,284025,2021-09-16 18:21:16
7129,26,Odisha,26746981,19930511,6816470,2021-09-16 18:21:16
7130,27,Puducherry,898594,664018,234576,2021-09-16 18:21:16
7131,28,Punjab,17172479,12978388,4194091,2021-09-16 18:21:16
7132,29,Rajasthan,51548630,38245603,13303027,2021-09-16 18:21:16
7133,30,Sikkim,800656,513534,287122,2021-09-16 18:21:16
7134,31,Tamil Nadu,40895074,32406009,8489065,2021-09-16 18:21:16
7135,32,Telangana,20499684,14822637,5677047,2021-09-16 18:21:16
7136,33,Tripura,3617772,2482097,1135675,2021-09-16 18:21:16
7137,34,Uttar Pradesh,90623112,75108573,15514539,2021-09-16 18:21:16
7138,35,Uttarakhand,9633422,7114858,2518564,2021-09-16 18:21:16
7139,36,West Bengal,48936886,34763574,14173312,2021-09-16 18:21:16
7140,37,Daman and Diu,367282,258722,108560,2021-09-16 18:21:16
7141,1,Andaman and Nicobar Islands,412139,284166,127973,2021-09-18 08:07:17
7142,2,Andhra Pradesh,36964680,25279290,11685390,2021-09-18 08:07:17
7143,3,Arunachal Pradesh,1070388,743915,326473,2021-09-18 08:07:17
7144,4,Assam,21784068,17299601,4484467,2021-09-18 08:07:17
7145,5,Bihar,49619485,40448891,9170594,2021-09-18 08:07:17
7146,6,Chandigarh,1261197,871150,390047,2021-09-18 08:07:17
7147,7,Chhattisgarh,15186072,11161873,4024199,2021-09-18 08:07:17
7148,8,Dadra and Nagar Haveli,471376,374364,97012,2021-09-18 08:07:17
7149,9,Delhi,15907504,11153740,4753764,2021-09-18 08:07:17
7150,10,Goa,1737960,1196590,541370,2021-09-18 08:07:17
7151,11,Gujarat,56241610,39769495,16472115,2021-09-18 08:07:17
7152,12,Haryana,20675841,15236454,5439387,2021-09-18 08:07:17
7153,13,Himachal Pradesh,7801111,5612051,2189060,2021-09-18 08:07:17
7154,14,Jammu and Kashmir,9957360,7143287,2814073,2021-09-18 08:07:17
7155,15,Jharkhand,15806624,12398793,3407831,2021-09-18 08:07:17
7156,16,Karnataka,51658550,37262200,14396350,2021-09-18 08:07:17
7157,17,Kerala,33465811,23709048,9756763,2021-09-18 08:07:17
7158,18,Ladakh,328311,200499,127812,2021-09-18 08:07:17
7159,19,Lakshadweep,90667,54183,36484,2021-09-18 08:07:17
7160,20,Madhya Pradesh,56691671,44659955,12031716,2021-09-18 08:07:17
7161,21,Maharashtra,72632062,52267759,20364303,2021-09-18 08:07:17
7162,22,Manipur,1623842,1213712,410130,2021-09-18 08:07:17
7163,23,Meghalaya,1456088,1056925,399163,2021-09-18 08:07:17
7164,24,Mizoram,1045598,684439,361159,2021-09-18 08:07:17
7165,25,Nagaland,966120,674608,291512,2021-09-18 08:07:17
7166,26,Odisha,27281870,20229077,7052793,2021-09-18 08:07:17
7167,27,Puducherry,915374,668576,246798,2021-09-18 08:07:17
7168,28,Punjab,17597272,13277012,4320260,2021-09-18 08:07:17
7169,29,Rajasthan,53203006,39132424,14070582,2021-09-18 08:07:17
7170,30,Sikkim,818265,514222,304043,2021-09-18 08:07:17
7171,31,Tamil Nadu,41393565,32688125,8705440,2021-09-18 08:07:17
7172,32,Telangana,21346559,15417632,5928927,2021-09-18 08:07:17
7173,33,Tripura,3633049,2482944,1150105,2021-09-18 08:07:17
7174,34,Uttar Pradesh,93759215,77371492,16387723,2021-09-18 08:07:17
7175,35,Uttarakhand,9883057,7197783,2685274,2021-09-18 08:07:17
7176,36,West Bengal,49802573,35322612,14479961,2021-09-18 08:07:17
7177,37,Daman and Diu,375978,260368,115610,2021-09-18 08:07:17
7178,1,Andaman and Nicobar Islands,414952,285173,129779,2021-09-18 18:19:51
7179,2,Andhra Pradesh,37148042,25379674,11768368,2021-09-18 18:19:51
7180,3,Arunachal Pradesh,1072333,744130,328203,2021-09-18 18:19:51
7181,4,Assam,21896392,17361497,4534895,2021-09-18 18:19:51
7182,5,Bihar,49930107,40654696,9275411,2021-09-18 18:19:51
7183,6,Chandigarh,1266097,873023,393074,2021-09-18 18:19:51
7184,7,Chhattisgarh,15387177,11275638,4111539,2021-09-18 18:19:51
7185,8,Dadra and Nagar Haveli,473384,374586,98798,2021-09-18 18:19:51
7186,9,Delhi,15983360,11192923,4790437,2021-09-18 18:19:51
7187,10,Goa,1747745,1198071,549674,2021-09-18 18:19:51
7188,11,Gujarat,56477449,39866638,16610811,2021-09-18 18:19:51
7189,12,Haryana,20789591,15318701,5470890,2021-09-18 18:19:51
7190,13,Himachal Pradesh,7821888,5614344,2207544,2021-09-18 18:19:51
7191,14,Jammu and Kashmir,10020240,7168952,2851288,2021-09-18 18:19:51
7192,15,Jharkhand,15920725,12474555,3446170,2021-09-18 18:19:51
7193,16,Karnataka,51910706,37376690,14534016,2021-09-18 18:19:51
7194,17,Kerala,33590949,23780572,9810377,2021-09-18 18:19:51
7195,18,Ladakh,328995,200754,128241,2021-09-18 18:19:51
7196,19,Lakshadweep,91265,54310,36955,2021-09-18 18:19:51
7197,20,Madhya Pradesh,57252417,44958787,12293630,2021-09-18 18:19:51
7198,21,Maharashtra,73294036,52681453,20612583,2021-09-18 18:19:51
7199,22,Manipur,1625809,1214100,411709,2021-09-18 18:19:51
7200,23,Meghalaya,1459249,1057366,401883,2021-09-18 18:19:51
7201,24,Mizoram,1047001,684563,362438,2021-09-18 18:19:51
7202,25,Nagaland,967033,674756,292277,2021-09-18 18:19:51
7203,26,Odisha,27447479,20320180,7127299,2021-09-18 18:19:51
7204,27,Puducherry,917536,669130,248406,2021-09-18 18:19:51
7205,28,Punjab,17707984,13360461,4347523,2021-09-18 18:19:51
7206,29,Rajasthan,53458984,39268528,14190456,2021-09-18 18:19:51
7207,30,Sikkim,823843,514426,309417,2021-09-18 18:19:51
7208,31,Tamil Nadu,41534891,32768271,8766620,2021-09-18 18:19:51
7209,32,Telangana,21663738,15662021,6001717,2021-09-18 18:19:51
7210,33,Tripura,3641623,2483465,1158158,2021-09-18 18:19:51
7211,34,Uttar Pradesh,94151721,77508147,16643574,2021-09-18 18:19:51
7212,35,Uttarakhand,9921672,7210280,2711392,2021-09-18 18:19:51
7213,36,West Bengal,50612188,35947735,14664453,2021-09-18 18:19:51
7214,37,Daman and Diu,377973,260473,117500,2021-09-18 18:19:51
7215,1,Andaman and Nicobar Islands,417642,286260,131382,2021-09-19 18:21:07
7216,2,Andhra Pradesh,37167351,25389663,11777688,2021-09-19 18:21:07
7217,3,Arunachal Pradesh,1073576,744261,329315,2021-09-19 18:21:07
7218,4,Assam,22002174,17422422,4579752,2021-09-19 18:21:07
7219,5,Bihar,50075791,40736666,9339125,2021-09-19 18:21:07
7220,6,Chandigarh,1271498,874987,396511,2021-09-19 18:21:07
7221,7,Chhattisgarh,15564556,11378064,4186492,2021-09-19 18:21:07
7222,8,Dadra and Nagar Haveli,474053,374707,99346,2021-09-19 18:21:07
7223,9,Delhi,16005232,11203425,4801807,2021-09-19 18:21:07
7224,10,Goa,1759433,1199656,559777,2021-09-19 18:21:07
7225,11,Gujarat,56701605,39955232,16746373,2021-09-19 18:21:07
7226,12,Haryana,20939672,15427895,5511777,2021-09-19 18:21:07
7227,13,Himachal Pradesh,7830736,5614837,2215899,2021-09-19 18:21:07
7228,14,Jammu and Kashmir,10098310,7204203,2894107,2021-09-19 18:21:07
7229,15,Jharkhand,16069034,12575385,3493649,2021-09-19 18:21:07
7230,16,Karnataka,51986994,37405979,14581015,2021-09-19 18:21:07
7231,17,Kerala,33641007,23807395,9833612,2021-09-19 18:21:07
7232,18,Ladakh,328995,200754,128241,2021-09-19 18:21:07
7233,19,Lakshadweep,91478,54337,37141,2021-09-19 18:21:07
7234,20,Madhya Pradesh,57531353,45115507,12415846,2021-09-19 18:21:07
7235,21,Maharashtra,73434816,52762401,20672415,2021-09-19 18:21:07
7236,22,Manipur,1626570,1214276,412294,2021-09-19 18:21:07
7237,23,Meghalaya,1459833,1057602,402231,2021-09-19 18:21:07
7238,24,Mizoram,1047001,684563,362438,2021-09-19 18:21:07
7239,25,Nagaland,970410,675073,295337,2021-09-19 18:21:07
7240,26,Odisha,27509847,20355272,7154575,2021-09-19 18:21:07
7241,27,Puducherry,921079,670172,250907,2021-09-19 18:21:07
7242,28,Punjab,17805980,13418166,4387814,2021-09-19 18:21:07
7243,29,Rajasthan,53564302,39320752,14243550,2021-09-19 18:21:07
7244,30,Sikkim,823843,514426,309417,2021-09-19 18:21:07
7245,31,Tamil Nadu,42977506,33709615,9267891,2021-09-19 18:21:07
7246,32,Telangana,22020636,15968838,6051798,2021-09-19 18:21:07
7247,33,Tripura,3642310,2483499,1158811,2021-09-19 18:21:07
7248,34,Uttar Pradesh,94200923,77539164,16661759,2021-09-19 18:21:07
7249,35,Uttarakhand,9955501,7219826,2735675,2021-09-19 18:21:07
7250,36,West Bengal,50907965,36173934,14734031,2021-09-19 18:21:07
7251,37,Daman and Diu,377973,260473,117500,2021-09-19 18:21:07
7252,1,Andaman and Nicobar Islands,421613,286760,134853,2021-09-20 18:21:15
7253,2,Andhra Pradesh,37984514,25756988,12227526,2021-09-20 18:21:15
7254,3,Arunachal Pradesh,1085812,745454,340358,2021-09-20 18:21:15
7255,4,Assam,22317411,17584157,4733254,2021-09-20 18:21:15
7256,5,Bihar,50948180,41369406,9578774,2021-09-20 18:21:15
7257,6,Chandigarh,1280159,878369,401790,2021-09-20 18:21:15
7258,7,Chhattisgarh,15950760,11581135,4369625,2021-09-20 18:21:15
7259,8,Dadra and Nagar Haveli,477006,375258,101748,2021-09-20 18:21:15
7260,9,Delhi,16216214,11314870,4901344,2021-09-20 18:21:15
7261,10,Goa,1776992,1202541,574451,2021-09-20 18:21:15
7262,11,Gujarat,57098999,40132276,16966723,2021-09-20 18:21:15
7263,12,Haryana,21207839,15614660,5593179,2021-09-20 18:21:15
7264,13,Himachal Pradesh,7912880,5622165,2290715,2021-09-20 18:21:15
7265,14,Jammu and Kashmir,10193666,7248954,2944712,2021-09-20 18:21:15
7266,15,Jharkhand,16258290,12697680,3560610,2021-09-20 18:21:15
7267,16,Karnataka,52335189,37562002,14773187,2021-09-20 18:21:15
7268,17,Kerala,33982049,24003365,9978684,2021-09-20 18:21:15
7269,18,Ladakh,330482,201226,129256,2021-09-20 18:21:15
7270,19,Lakshadweep,92253,54427,37826,2021-09-20 18:21:15
7271,20,Madhya Pradesh,58234388,45458337,12776051,2021-09-20 18:21:15
7272,21,Maharashtra,74325326,53275043,21050283,2021-09-20 18:21:15
7273,22,Manipur,1633979,1215254,418725,2021-09-20 18:21:15
7274,23,Meghalaya,1470468,1059249,411219,2021-09-20 18:21:15
7275,24,Mizoram,1058812,686061,372751,2021-09-20 18:21:15
7276,25,Nagaland,980600,676490,304110,2021-09-20 18:21:15
7277,26,Odisha,27940390,20588044,7352346,2021-09-20 18:21:15
7278,27,Puducherry,932504,673675,258829,2021-09-20 18:21:15
7279,28,Punjab,17935516,13492124,4443392,2021-09-20 18:21:15
7280,29,Rajasthan,53743267,39410271,14332996,2021-09-20 18:21:15
7281,30,Sikkim,826977,514548,312429,2021-09-20 18:21:15
7282,31,Tamil Nadu,43204025,33847080,9356945,2021-09-20 18:21:15
7283,32,Telangana,22431304,16295295,6136009,2021-09-20 18:21:15
7284,33,Tripura,3678773,2485119,1193654,2021-09-20 18:21:15
7285,34,Uttar Pradesh,95808234,78726529,17081705,2021-09-20 18:21:15
7286,35,Uttarakhand,10031376,7243719,2787657,2021-09-20 18:21:15
7287,36,West Bengal,51800622,36806726,14993896,2021-09-20 18:21:15
7288,37,Daman and Diu,382315,261100,121215,2021-09-20 18:21:15
7289,1,Andaman and Nicobar Islands,426143,287183,138960,2021-09-21 18:21:07
7290,2,Andhra Pradesh,38379653,25954875,12424778,2021-09-21 18:21:07
7291,3,Arunachal Pradesh,1095617,746437,349180,2021-09-21 18:21:07
7292,4,Assam,22593398,17734294,4859104,2021-09-21 18:21:07
7293,5,Bihar,51520645,41756963,9763682,2021-09-21 18:21:07
7294,6,Chandigarh,1287838,881183,406655,2021-09-21 18:21:07
7295,7,Chhattisgarh,16205646,11714633,4491013,2021-09-21 18:21:07
7296,8,Dadra and Nagar Haveli,480562,375870,104692,2021-09-21 18:21:07
7297,9,Delhi,16412390,11413942,4998448,2021-09-21 18:21:07
7298,10,Goa,1793533,1205186,588347,2021-09-21 18:21:07
7299,11,Gujarat,57381087,40263325,17117762,2021-09-21 18:21:07
7300,12,Haryana,21497735,15810801,5686934,2021-09-21 18:21:07
7301,13,Himachal Pradesh,7992193,5627461,2364732,2021-09-21 18:21:07
7302,14,Jammu and Kashmir,10298058,7300760,2997298,2021-09-21 18:21:07
7303,15,Jharkhand,16445727,12818622,3627105,2021-09-21 18:21:07
7304,16,Karnataka,52673036,37700773,14972263,2021-09-21 18:21:07
7305,17,Kerala,34217365,24124621,10092744,2021-09-21 18:21:07
7306,18,Ladakh,332039,201904,130135,2021-09-21 18:21:07
7307,19,Lakshadweep,92891,54481,38410,2021-09-21 18:21:07
7308,20,Madhya Pradesh,58711305,45739621,12971684,2021-09-21 18:21:07
7309,21,Maharashtra,75055742,53695886,21359856,2021-09-21 18:21:07
7310,22,Manipur,1638971,1215841,423130,2021-09-21 18:21:07
7311,23,Meghalaya,1478761,1060881,417880,2021-09-21 18:21:07
7312,24,Mizoram,1071373,687871,383502,2021-09-21 18:21:07
7313,25,Nagaland,988823,677792,311031,2021-09-21 18:21:07
7314,26,Odisha,28309090,20813239,7495851,2021-09-21 18:21:07
7315,27,Puducherry,941555,676619,264936,2021-09-21 18:21:07
7316,28,Punjab,18013805,13538642,4475163,2021-09-21 18:21:07
7317,29,Rajasthan,53901358,39481070,14420288,2021-09-21 18:21:07
7318,30,Sikkim,841600,515147,326453,2021-09-21 18:21:07
7319,31,Tamil Nadu,43357046,33927644,9429402,2021-09-21 18:21:07
7320,32,Telangana,22967138,16691349,6275789,2021-09-21 18:21:07
7321,33,Tripura,3711770,2486756,1225014,2021-09-21 18:21:07
7322,34,Uttar Pradesh,96826491,79438174,17388317,2021-09-21 18:21:07
7323,35,Uttarakhand,10098903,7262713,2836190,2021-09-21 18:21:07
7324,36,West Bengal,52941036,37679266,15261770,2021-09-21 18:21:07
7325,37,Daman and Diu,386453,261728,124725,2021-09-21 18:21:07
7326,1,Andaman and Nicobar Islands,429980,287530,142450,2021-09-22 18:07:30
7327,2,Andhra Pradesh,38534126,26024581,12509545,2021-09-22 18:07:30
7328,3,Arunachal Pradesh,1105145,747590,357555,2021-09-22 18:07:30
7329,4,Assam,22744906,17817198,4927708,2021-09-22 18:07:30
7330,5,Bihar,51808768,41939805,9868963,2021-09-22 18:07:30
7331,6,Chandigarh,1296091,883985,412106,2021-09-22 18:07:30
7332,7,Chhattisgarh,16472245,11850532,4621713,2021-09-22 18:07:30
7333,8,Dadra and Nagar Haveli,482914,376353,106561,2021-09-22 18:07:30
7334,9,Delhi,16588806,11500638,5088168,2021-09-22 18:07:30
7335,10,Goa,1811197,1207684,603513,2021-09-22 18:07:30
7336,11,Gujarat,58032780,40568010,17464770,2021-09-22 18:07:30
7337,12,Haryana,21646922,15903756,5743166,2021-09-22 18:07:30
7338,13,Himachal Pradesh,8061297,5632996,2428301,2021-09-22 18:07:30
7339,14,Jammu and Kashmir,10415855,7362625,3053230,2021-09-22 18:07:30
7340,15,Jharkhand,16653226,12954544,3698682,2021-09-22 18:07:30
7341,16,Karnataka,53716474,38176644,15539830,2021-09-22 18:07:30
7342,17,Kerala,34432961,24234837,10198124,2021-09-22 18:07:30
7343,18,Ladakh,333524,202465,131059,2021-09-22 18:07:30
7344,19,Lakshadweep,93454,54560,38894,2021-09-22 18:07:30
7345,20,Madhya Pradesh,59170801,45983243,13187558,2021-09-22 18:07:30
7346,21,Maharashtra,76162365,54359497,21802868,2021-09-22 18:07:30
7347,22,Manipur,1645650,1216639,429011,2021-09-22 18:07:30
7348,23,Meghalaya,1487171,1062244,424927,2021-09-22 18:07:30
7349,24,Mizoram,1082925,689427,393498,2021-09-22 18:07:30
7350,25,Nagaland,999533,679036,320497,2021-09-22 18:07:30
7351,26,Odisha,28703771,21035669,7668102,2021-09-22 18:07:30
7352,27,Puducherry,950891,679659,271232,2021-09-22 18:07:30
7353,28,Punjab,18067474,13570571,4496903,2021-09-22 18:07:30
7354,29,Rajasthan,54011123,39525796,14485327,2021-09-22 18:07:30
7355,30,Sikkim,855172,515750,339422,2021-09-22 18:07:30
7356,31,Tamil Nadu,43506795,34014397,9492398,2021-09-22 18:07:30
7357,32,Telangana,23124286,16812162,6312124,2021-09-22 18:07:30
7358,33,Tripura,3727718,2487527,1240191,2021-09-22 18:07:30
7359,34,Uttar Pradesh,97603201,79969437,17633764,2021-09-22 18:07:30
7360,35,Uttarakhand,10156113,7278263,2877850,2021-09-22 18:07:30
7361,36,West Bengal,53551144,38093807,15457337,2021-09-22 18:07:30
7362,37,Daman and Diu,390480,262257,128223,2021-09-22 18:07:30
7363,1,Andaman and Nicobar Islands,432383,287854,144529,2021-09-23 18:21:54
7364,2,Andhra Pradesh,38817277,26156928,12660349,2021-09-23 18:21:54
7365,3,Arunachal Pradesh,1115445,748698,366747,2021-09-23 18:21:54
7366,4,Assam,22960641,17927859,5032782,2021-09-23 18:21:54
7367,5,Bihar,52089000,42106530,9982470,2021-09-23 18:21:54
7368,6,Chandigarh,1301649,885927,415722,2021-09-23 18:21:54
7369,7,Chhattisgarh,16755256,11997996,4757260,2021-09-23 18:21:54
7370,8,Dadra and Nagar Haveli,485868,376827,109041,2021-09-23 18:21:54
7371,9,Delhi,16776883,11586341,5190542,2021-09-23 18:21:54
7372,10,Goa,1825749,1209915,615834,2021-09-23 18:21:54
7373,11,Gujarat,58370418,40741856,17628562,2021-09-23 18:21:54
7374,12,Haryana,21788756,15992555,5796201,2021-09-23 18:21:54
7375,13,Himachal Pradesh,8112011,5636538,2475473,2021-09-23 18:21:54
7376,14,Jammu and Kashmir,10555643,7439859,3115784,2021-09-23 18:21:54
7377,15,Jharkhand,16803996,13048227,3755769,2021-09-23 18:21:54
7378,16,Karnataka,53948233,38271446,15676787,2021-09-23 18:21:54
7379,17,Kerala,34672894,24341256,10331638,2021-09-23 18:21:54
7380,18,Ladakh,334856,202848,132008,2021-09-23 18:21:54
7381,19,Lakshadweep,93890,54576,39314,2021-09-23 18:21:54
7382,20,Madhya Pradesh,59878040,46359916,13518124,2021-09-23 18:21:54
7383,21,Maharashtra,76919531,54811638,22107893,2021-09-23 18:21:54
7384,22,Manipur,1651543,1217411,434132,2021-09-23 18:21:54
7385,23,Meghalaya,1495851,1063906,431945,2021-09-23 18:21:54
7386,24,Mizoram,1093157,690702,402455,2021-09-23 18:21:54
7387,25,Nagaland,1006266,679956,326310,2021-09-23 18:21:54
7388,26,Odisha,29100094,21268200,7831894,2021-09-23 18:21:54
7389,27,Puducherry,959992,682827,277165,2021-09-23 18:21:54
7390,28,Punjab,18504394,13872774,4631620,2021-09-23 18:21:54
7391,29,Rajasthan,54056788,39544831,14511957,2021-09-23 18:21:54
7392,30,Sikkim,868303,516318,351985,2021-09-23 18:21:54
7393,31,Tamil Nadu,43697815,34117980,9579835,2021-09-23 18:21:54
7394,32,Telangana,23627041,17183461,6443580,2021-09-23 18:21:54
7395,33,Tripura,3760886,2489250,1271636,2021-09-23 18:21:54
7396,34,Uttar Pradesh,98879112,80881956,17997156,2021-09-23 18:21:54
7397,35,Uttarakhand,10217894,7294313,2923581,2021-09-23 18:21:54
7398,36,West Bengal,54040351,38404978,15635373,2021-09-23 18:21:54
7399,37,Daman and Diu,394934,263058,131876,2021-09-23 18:21:54
7400,1,Andaman and Nicobar Islands,434385,288184,146201,2021-09-24 18:21:15
7401,2,Andhra Pradesh,38930239,26211260,12718979,2021-09-24 18:21:15
7402,3,Arunachal Pradesh,1126160,749994,376166,2021-09-24 18:21:15
7403,4,Assam,23161565,18021533,5140032,2021-09-24 18:21:15
7404,5,Bihar,52533420,42387657,10145763,2021-09-24 18:21:15
7405,6,Chandigarh,1309354,888315,421039,2021-09-24 18:21:15
7406,7,Chhattisgarh,16985131,12121899,4863232,2021-09-24 18:21:15
7407,8,Dadra and Nagar Haveli,490070,377467,112603,2021-09-24 18:21:15
7408,9,Delhi,16939273,11657445,5281828,2021-09-24 18:21:15
7409,10,Goa,1840721,1212471,628250,2021-09-24 18:21:15
7410,11,Gujarat,58911395,41002782,17908613,2021-09-24 18:21:15
7411,12,Haryana,21993951,16110147,5883804,2021-09-24 18:21:15
7412,13,Himachal Pradesh,8170130,5641906,2528224,2021-09-24 18:21:15
7413,14,Jammu and Kashmir,10702882,7517092,3185790,2021-09-24 18:21:15
7414,15,Jharkhand,16994396,13172658,3821738,2021-09-24 18:21:15
7415,16,Karnataka,54297022,38424440,15872582,2021-09-24 18:21:15
7416,17,Kerala,34870074,24424390,10445684,2021-09-24 18:21:15
7417,18,Ladakh,336017,203237,132780,2021-09-24 18:21:15
7418,19,Lakshadweep,94130,54593,39537,2021-09-24 18:21:15
7419,20,Madhya Pradesh,60287271,46613775,13673496,2021-09-24 18:21:15
7420,21,Maharashtra,77464751,55096296,22368455,2021-09-24 18:21:15
7421,22,Manipur,1660808,1218379,442429,2021-09-24 18:21:15
7422,23,Meghalaya,1504179,1065277,438902,2021-09-24 18:21:15
7423,24,Mizoram,1103553,691907,411646,2021-09-24 18:21:15
7424,25,Nagaland,1013867,681076,332791,2021-09-24 18:21:15
7425,26,Odisha,29409901,21458958,7950943,2021-09-24 18:21:15
7426,27,Puducherry,968922,685917,283005,2021-09-24 18:21:15
7427,28,Punjab,18700344,14005256,4695088,2021-09-24 18:21:15
7428,29,Rajasthan,54548924,39786801,14762123,2021-09-24 18:21:15
7429,30,Sikkim,879430,516877,362553,2021-09-24 18:21:15
7430,31,Tamil Nadu,43922120,34220158,9701962,2021-09-24 18:21:15
7431,32,Telangana,24097052,17521366,6575686,2021-09-24 18:21:15
7432,33,Tripura,3770981,2489763,1281218,2021-09-24 18:21:15
7433,34,Uttar Pradesh,99714493,81450439,18264054,2021-09-24 18:21:15
7434,35,Uttarakhand,10270071,7307757,2962314,2021-09-24 18:21:15
7435,36,West Bengal,54985590,39104475,15881115,2021-09-24 18:21:15
7436,37,Daman and Diu,398311,263486,134825,2021-09-24 18:21:15
7437,1,Andaman and Nicobar Islands,436538,288494,148044,2021-09-25 18:19:31
7438,2,Andhra Pradesh,38995682,26240008,12755674,2021-09-25 18:19:31
7439,3,Arunachal Pradesh,1134622,751045,383577,2021-09-25 18:19:31
7440,4,Assam,23350843,18107640,5243203,2021-09-25 18:19:31
7441,5,Bihar,53137117,42780750,10356367,2021-09-25 18:19:31
7442,6,Chandigarh,1319990,891311,428679,2021-09-25 18:19:31
7443,7,Chhattisgarh,17216795,12238174,4978621,2021-09-25 18:19:31
7444,8,Dadra and Nagar Haveli,494593,378140,116453,2021-09-25 18:19:31
7445,9,Delhi,17149151,11739928,5409223,2021-09-25 18:19:31
7446,10,Goa,1860499,1215672,644827,2021-09-25 18:19:31
7447,11,Gujarat,59411024,41250463,18160561,2021-09-25 18:19:31
7448,12,Haryana,22201429,16218966,5982463,2021-09-25 18:19:31
7449,13,Himachal Pradesh,8222813,5646349,2576464,2021-09-25 18:19:31
7450,14,Jammu and Kashmir,10842493,7590642,3251851,2021-09-25 18:19:31
7451,15,Jharkhand,17143745,13264768,3878977,2021-09-25 18:19:31
7452,16,Karnataka,54582052,38516497,16065555,2021-09-25 18:19:31
7453,17,Kerala,35064476,24493856,10570620,2021-09-25 18:19:31
7454,18,Ladakh,336986,203581,133405,2021-09-25 18:19:31
7455,19,Lakshadweep,94740,54687,40053,2021-09-25 18:19:31
7456,20,Madhya Pradesh,60844892,46899052,13945840,2021-09-25 18:19:31
7457,21,Maharashtra,78101728,55411907,22689821,2021-09-25 18:19:31
7458,22,Manipur,1670291,1219482,450809,2021-09-25 18:19:31
7459,23,Meghalaya,1510424,1066150,444274,2021-09-25 18:19:31
7460,24,Mizoram,1105943,692642,413301,2021-09-25 18:19:31
7461,25,Nagaland,1016337,681468,334869,2021-09-25 18:19:31
7462,26,Odisha,29683698,21629384,8054314,2021-09-25 18:19:31
7463,27,Puducherry,980286,689249,291037,2021-09-25 18:19:31
7464,28,Punjab,19135879,14278434,4857445,2021-09-25 18:19:31
7465,29,Rajasthan,54900232,39955425,14944807,2021-09-25 18:19:31
7466,30,Sikkim,883039,517068,365971,2021-09-25 18:19:31
7467,31,Tamil Nadu,44150810,34319211,9831599,2021-09-25 18:19:31
7468,32,Telangana,24621292,17892184,6729108,2021-09-25 18:19:31
7469,33,Tripura,3794353,2490973,1303380,2021-09-25 18:19:31
7470,34,Uttar Pradesh,100288621,81601801,18686820,2021-09-25 18:19:31
7471,35,Uttarakhand,10320053,7319589,3000464,2021-09-25 18:19:31
7472,36,West Bengal,55572247,39509357,16062890,2021-09-25 18:19:31
7473,37,Daman and Diu,403100,264076,139024,2021-09-25 18:19:31
7474,1,Andaman and Nicobar Islands,436631,288523,148108,2021-09-26 18:21:50
7475,2,Andhra Pradesh,39156311,26331175,12825136,2021-09-26 18:21:50
7476,3,Arunachal Pradesh,1137064,751290,385774,2021-09-26 18:21:50
7477,4,Assam,23426478,18149838,5276640,2021-09-26 18:21:50
7478,5,Bihar,53378233,42942462,10435771,2021-09-26 18:21:50
7479,6,Chandigarh,1324994,892804,432190,2021-09-26 18:21:50
7480,7,Chhattisgarh,17302668,12277387,5025281,2021-09-26 18:21:50
7481,8,Dadra and Nagar Haveli,495328,378261,117067,2021-09-26 18:21:50
7482,9,Delhi,17171046,11749447,5421599,2021-09-26 18:21:50
7483,10,Goa,1871886,1217302,654584,2021-09-26 18:21:50
7484,11,Gujarat,59532269,41318095,18214174,2021-09-26 18:21:50
7485,12,Haryana,22299800,16273835,6025965,2021-09-26 18:21:50
7486,13,Himachal Pradesh,8227255,5646719,2580536,2021-09-26 18:21:50
7487,14,Jammu and Kashmir,10942815,7647645,3295170,2021-09-26 18:21:50
7488,15,Jharkhand,17276778,13347264,3929514,2021-09-26 18:21:50
7489,16,Karnataka,54620115,38531738,16088377,2021-09-26 18:21:50
7490,17,Kerala,35111973,24521633,10590340,2021-09-26 18:21:50
7491,18,Ladakh,336991,203581,133410,2021-09-26 18:21:50
7492,19,Lakshadweep,94920,54728,40192,2021-09-26 18:21:50
7493,20,Madhya Pradesh,61117128,47080225,14036903,2021-09-26 18:21:50
7494,21,Maharashtra,78325412,55542467,22782945,2021-09-26 18:21:50
7495,22,Manipur,1671138,1219634,451504,2021-09-26 18:21:50
7496,23,Meghalaya,1510785,1066267,444518,2021-09-26 18:21:50
7497,24,Mizoram,1106229,692897,413332,2021-09-26 18:21:50
7498,25,Nagaland,1018750,681792,336958,2021-09-26 18:21:50
7499,26,Odisha,29715973,21650429,8065544,2021-09-26 18:21:50
7500,27,Puducherry,984205,690497,293708,2021-09-26 18:21:50
7501,28,Punjab,19261360,14352315,4909045,2021-09-26 18:21:50
7502,29,Rajasthan,54909809,39960044,14949765,2021-09-26 18:21:50
7503,30,Sikkim,883242,517083,366159,2021-09-26 18:21:50
7504,31,Tamil Nadu,46140708,35443779,10696929,2021-09-26 18:21:50
7505,32,Telangana,24706048,17963032,6743016,2021-09-26 18:21:50
7506,33,Tripura,3795095,2491018,1304077,2021-09-26 18:21:50
7507,34,Uttar Pradesh,100309580,81608293,18701287,2021-09-26 18:21:50
7508,35,Uttarakhand,10340170,7324119,3016051,2021-09-26 18:21:50
7509,36,West Bengal,55732601,39635987,16096614,2021-09-26 18:21:50
7510,37,Daman and Diu,403101,264076,139025,2021-09-26 18:21:50
7511,1,Andaman and Nicobar Islands,438499,288877,149622,2021-09-27 18:21:40
7512,2,Andhra Pradesh,39735530,26636192,13099338,2021-09-27 18:21:40
7513,3,Arunachal Pradesh,1148557,752572,395985,2021-09-27 18:21:40
7514,4,Assam,23633652,18251763,5381889,2021-09-27 18:21:40
7515,5,Bihar,53811007,43226290,10584717,2021-09-27 18:21:40
7516,6,Chandigarh,1331719,895064,436655,2021-09-27 18:21:40
7517,7,Chhattisgarh,17428594,12340695,5087899,2021-09-27 18:21:40
7518,8,Dadra and Nagar Haveli,499041,378823,120218,2021-09-27 18:21:40
7519,9,Delhi,17377051,11840383,5536668,2021-09-27 18:21:40
7520,10,Goa,1888335,1220106,668229,2021-09-27 18:21:40
7521,11,Gujarat,60057732,41570211,18487521,2021-09-27 18:21:40
7522,12,Haryana,22423036,16339366,6083670,2021-09-27 18:21:40
7523,13,Himachal Pradesh,8279229,5651396,2627833,2021-09-27 18:21:40
7524,14,Jammu and Kashmir,11078051,7720111,3357940,2021-09-27 18:21:40
7525,15,Jharkhand,17415667,13432543,3983124,2021-09-27 18:21:40
7526,16,Karnataka,54919936,38646702,16273234,2021-09-27 18:21:40
7527,17,Kerala,35174862,24544948,10629914,2021-09-27 18:21:40
7528,18,Ladakh,338058,203901,134157,2021-09-27 18:21:40
7529,19,Lakshadweep,95642,54767,40875,2021-09-27 18:21:40
7530,20,Madhya Pradesh,62373323,47718986,14654337,2021-09-27 18:21:40
7531,21,Maharashtra,79376483,56167504,23208979,2021-09-27 18:21:40
7532,22,Manipur,1681787,1220709,461078,2021-09-27 18:21:40
7533,23,Meghalaya,1520353,1067851,452502,2021-09-27 18:21:40
7534,24,Mizoram,1113639,693977,419662,2021-09-27 18:21:40
7535,25,Nagaland,1028588,683277,345311,2021-09-27 18:21:40
7536,26,Odisha,29806353,21697322,8109031,2021-09-27 18:21:40
7537,27,Puducherry,995714,694566,301148,2021-09-27 18:21:40
7538,28,Punjab,19328409,14396017,4932392,2021-09-27 18:21:40
7539,29,Rajasthan,55102151,40042152,15059999,2021-09-27 18:21:40
7540,30,Sikkim,890221,517475,372746,2021-09-27 18:21:40
7541,31,Tamil Nadu,46406702,35589539,10817163,2021-09-27 18:21:40
7542,32,Telangana,25050075,18210810,6839265,2021-09-27 18:21:40
7543,33,Tripura,3823350,2492443,1330907,2021-09-27 18:21:40
7544,34,Uttar Pradesh,103913004,84253017,19659987,2021-09-27 18:21:40
7545,35,Uttarakhand,10384230,7334451,3049779,2021-09-27 18:21:40
7546,36,West Bengal,56315429,40045812,16269617,2021-09-27 18:21:40
7547,37,Daman and Diu,406480,264575,141905,2021-09-27 18:21:40
7548,1,Andaman and Nicobar Islands,439808,289147,150661,2021-09-28 18:21:12
7549,2,Andhra Pradesh,40061545,26822850,13238695,2021-09-28 18:21:12
7550,3,Arunachal Pradesh,1157172,753754,403418,2021-09-28 18:21:12
7551,4,Assam,23797804,18337823,5459981,2021-09-28 18:21:12
7552,5,Bihar,54070047,43390001,10680046,2021-09-28 18:21:12
7553,6,Chandigarh,1338640,897312,441328,2021-09-28 18:21:12
7554,7,Chhattisgarh,17544423,12397213,5147210,2021-09-28 18:21:12
7555,8,Dadra and Nagar Haveli,502709,379370,123339,2021-09-28 18:21:12
7556,9,Delhi,17557750,11921965,5635785,2021-09-28 18:21:12
7557,10,Goa,1902685,1222366,680319,2021-09-28 18:21:12
7558,11,Gujarat,60353686,41714719,18638967,2021-09-28 18:21:12
7559,12,Haryana,22555562,16410347,6145215,2021-09-28 18:21:12
7560,13,Himachal Pradesh,8324209,5655422,2668787,2021-09-28 18:21:12
7561,14,Jammu and Kashmir,11214686,7790776,3423910,2021-09-28 18:21:12
7562,15,Jharkhand,17534734,13506398,4028336,2021-09-28 18:21:12
7563,16,Karnataka,55144482,38730365,16414117,2021-09-28 18:21:12
7564,17,Kerala,35372367,24610962,10761405,2021-09-28 18:21:12
7565,18,Ladakh,339413,204333,135080,2021-09-28 18:21:12
7566,19,Lakshadweep,95869,54776,41093,2021-09-28 18:21:12
7567,20,Madhya Pradesh,62635756,47886377,14749379,2021-09-28 18:21:12
7568,21,Maharashtra,80108438,56541192,23567246,2021-09-28 18:21:12
7569,22,Manipur,1689933,1221560,468373,2021-09-28 18:21:12
7570,23,Meghalaya,1528667,1069201,459466,2021-09-28 18:21:12
7571,24,Mizoram,1122100,695390,426710,2021-09-28 18:21:12
7572,25,Nagaland,1037496,684749,352747,2021-09-28 18:21:12
7573,26,Odisha,30010761,21800757,8210004,2021-09-28 18:21:12
7574,27,Puducherry,1003916,697327,306589,2021-09-28 18:21:12
7575,28,Punjab,19413161,14446446,4966715,2021-09-28 18:21:12
7576,29,Rajasthan,55335195,40135669,15199526,2021-09-28 18:21:12
7577,30,Sikkim,896834,517794,379040,2021-09-28 18:21:12
7578,31,Tamil Nadu,46643099,35712014,10931085,2021-09-28 18:21:12
7579,32,Telangana,25193503,18303730,6889773,2021-09-28 18:21:12
7580,33,Tripura,3846868,2493458,1353410,2021-09-28 18:21:12
7581,34,Uttar Pradesh,105213052,85112477,20100575,2021-09-28 18:21:12
7582,35,Uttarakhand,10423799,7343595,3080204,2021-09-28 18:21:12
7583,36,West Bengal,56768186,40347870,16420316,2021-09-28 18:21:12
7584,37,Daman and Diu,409418,265018,144400,2021-09-28 18:21:12
7585,1,Andaman and Nicobar Islands,441580,289456,152124,2021-09-29 18:21:16
7586,2,Andhra Pradesh,40820548,27223665,13596883,2021-09-29 18:21:16
7587,3,Arunachal Pradesh,1165343,754744,410599,2021-09-29 18:21:16
7588,4,Assam,23909756,18402052,5507704,2021-09-29 18:21:16
7589,5,Bihar,54160726,43441745,10718981,2021-09-29 18:21:16
7590,6,Chandigarh,1344186,899116,445070,2021-09-29 18:21:16
7591,7,Chhattisgarh,17640976,12445158,5195818,2021-09-29 18:21:16
7592,8,Dadra and Nagar Haveli,505310,379823,125487,2021-09-29 18:21:16
7593,9,Delhi,17710047,11993231,5716816,2021-09-29 18:21:16
7594,10,Goa,1914645,1224184,690461,2021-09-29 18:21:16
7595,11,Gujarat,60584124,41825605,18758519,2021-09-29 18:21:16
7596,12,Haryana,22694894,16486801,6208093,2021-09-29 18:21:16
7597,13,Himachal Pradesh,8361197,5658695,2702502,2021-09-29 18:21:16
7598,14,Jammu and Kashmir,11335641,7853389,3482252,2021-09-29 18:21:16
7599,15,Jharkhand,17630121,13563006,4067115,2021-09-29 18:21:16
7600,16,Karnataka,56211787,39174716,17037071,2021-09-29 18:21:16
7601,17,Kerala,35504843,24648955,10855888,2021-09-29 18:21:16
7602,18,Ladakh,341476,204742,136734,2021-09-29 18:21:16
7603,19,Lakshadweep,96158,54806,41352,2021-09-29 18:21:16
7604,20,Madhya Pradesh,63019458,48094358,14925100,2021-09-29 18:21:16
7605,21,Maharashtra,81004031,57090054,23913977,2021-09-29 18:21:16
7606,22,Manipur,1700041,1223296,476745,2021-09-29 18:21:16
7607,23,Meghalaya,1536141,1070467,465674,2021-09-29 18:21:16
7608,24,Mizoram,1131244,696272,434972,2021-09-29 18:21:16
7609,25,Nagaland,1046873,685994,360879,2021-09-29 18:21:16
7610,26,Odisha,30384263,22014100,8370163,2021-09-29 18:21:16
7611,27,Puducherry,1011237,699619,311618,2021-09-29 18:21:16
7612,28,Punjab,19473162,14479233,4993929,2021-09-29 18:21:16
7613,29,Rajasthan,55740882,40293764,15447118,2021-09-29 18:21:16
7614,30,Sikkim,902451,518116,384335,2021-09-29 18:21:16
7615,31,Tamil Nadu,46869492,35833391,11036101,2021-09-29 18:21:16
7616,32,Telangana,25277691,18357418,6920273,2021-09-29 18:21:16
7617,33,Tripura,3859669,2494132,1365537,2021-09-29 18:21:16
7618,34,Uttar Pradesh,105944494,85573046,20371448,2021-09-29 18:21:16
7619,35,Uttarakhand,10456831,7351394,3105437,2021-09-29 18:21:16
7620,36,West Bengal,57256872,40716677,16540195,2021-09-29 18:21:16
7621,37,Daman and Diu,411156,265269,145887,2021-09-29 18:21:16
7622,1,Andaman and Nicobar Islands,442942,289728,153214,2021-09-30 18:21:15
7623,2,Andhra Pradesh,41096129,27390009,13706120,2021-09-30 18:21:15
7624,3,Arunachal Pradesh,1173531,755858,417673,2021-09-30 18:21:15
7625,4,Assam,24021820,18469669,5552151,2021-09-30 18:21:15
7626,5,Bihar,54351618,43548742,10802876,2021-09-30 18:21:15
7627,6,Chandigarh,1350044,900985,449059,2021-09-30 18:21:15
7628,7,Chhattisgarh,17786234,12514887,5271347,2021-09-30 18:21:15
7629,8,Dadra and Nagar Haveli,508694,380257,128437,2021-09-30 18:21:15
7630,9,Delhi,17879308,12068732,5810576,2021-09-30 18:21:15
7631,10,Goa,1924680,1225781,698899,2021-09-30 18:21:15
7632,11,Gujarat,61024185,42021479,19002706,2021-09-30 18:21:15
7633,12,Haryana,22930917,16606956,6323961,2021-09-30 18:21:15
7634,13,Himachal Pradesh,8392885,5661779,2731106,2021-09-30 18:21:15
7635,14,Jammu and Kashmir,11478723,7938371,3540352,2021-09-30 18:21:15
7636,15,Jharkhand,17723003,13616971,4106032,2021-09-30 18:21:15
7637,16,Karnataka,56437074,39259617,17177457,2021-09-30 18:21:15
7638,17,Kerala,35638881,24695529,10943352,2021-09-30 18:21:15
7639,18,Ladakh,343225,205283,137942,2021-09-30 18:21:15
7640,19,Lakshadweep,96403,54818,41585,2021-09-30 18:21:15
7641,20,Madhya Pradesh,63610319,48422635,15187684,2021-09-30 18:21:15
7642,21,Maharashtra,81893727,57632025,24261702,2021-09-30 18:21:15
7643,22,Manipur,1702905,1223626,479279,2021-09-30 18:21:15
7644,23,Meghalaya,1543284,1071613,471671,2021-09-30 18:21:15
7645,24,Mizoram,1138227,696933,441294,2021-09-30 18:21:15
7646,25,Nagaland,1053691,686908,366783,2021-09-30 18:21:15
7647,26,Odisha,30755031,22230694,8524337,2021-09-30 18:21:15
7648,27,Puducherry,1017412,701667,315745,2021-09-30 18:21:15
7649,28,Punjab,19538082,14513084,5024998,2021-09-30 18:21:15
7650,29,Rajasthan,56075393,40435241,15640152,2021-09-30 18:21:15
7651,30,Sikkim,908673,518476,390197,2021-09-30 18:21:15
7652,31,Tamil Nadu,47204713,36010365,11194348,2021-09-30 18:21:15
7653,32,Telangana,25697179,18648641,7048538,2021-09-30 18:21:15
7654,33,Tripura,3882791,2495205,1387586,2021-09-30 18:21:15
7655,34,Uttar Pradesh,106842717,86136561,20706156,2021-09-30 18:21:15
7656,35,Uttarakhand,10499878,7360563,3139315,2021-09-30 18:21:15
7657,36,West Bengal,57761860,41079677,16682183,2021-09-30 18:21:15
7658,37,Daman and Diu,413616,265562,148054,2021-09-30 18:21:15
7659,1,Andaman and Nicobar Islands,444242,289980,154262,2021-10-01 18:21:14
7660,2,Andhra Pradesh,41714184,27751626,13962558,2021-10-01 18:21:14
7661,3,Arunachal Pradesh,1181387,756848,424539,2021-10-01 18:21:14
7662,4,Assam,24099000,18514304,5584696,2021-10-01 18:21:14
7663,5,Bihar,54439416,43582577,10856839,2021-10-01 18:21:14
7664,6,Chandigarh,1357130,902936,454194,2021-10-01 18:21:14
7665,7,Chhattisgarh,17896920,12566270,5330650,2021-10-01 18:21:14
7666,8,Dadra and Nagar Haveli,513128,380771,132357,2021-10-01 18:21:14
7667,9,Delhi,18065473,12144237,5921236,2021-10-01 18:21:14
7668,10,Goa,1937243,1227878,709365,2021-10-01 18:21:14
7669,11,Gujarat,61231247,42119082,19112165,2021-10-01 18:21:14
7670,12,Haryana,23164064,16722570,6441494,2021-10-01 18:21:14
7671,13,Himachal Pradesh,8431550,5664849,2766701,2021-10-01 18:21:14
7672,14,Jammu and Kashmir,11618480,8022402,3596078,2021-10-01 18:21:14
7673,15,Jharkhand,17863204,13695874,4167330,2021-10-01 18:21:14
7674,16,Karnataka,56687438,39347554,17339884,2021-10-01 18:21:14
7675,17,Kerala,35769969,24730896,11039073,2021-10-01 18:21:14
7676,18,Ladakh,344186,205532,138654,2021-10-01 18:21:14
7677,19,Lakshadweep,96764,54843,41921,2021-10-01 18:21:14
7678,20,Madhya Pradesh,63804532,48530783,15273749,2021-10-01 18:21:14
7679,21,Maharashtra,82735878,58105633,24630245,2021-10-01 18:21:14
7680,22,Manipur,1714017,1224679,489338,2021-10-01 18:21:14
7681,23,Meghalaya,1550827,1072825,478002,2021-10-01 18:21:14
7682,24,Mizoram,1143638,697715,445923,2021-10-01 18:21:14
7683,25,Nagaland,1060625,688096,372529,2021-10-01 18:21:14
7684,26,Odisha,31007510,22367403,8640107,2021-10-01 18:21:14
7685,27,Puducherry,1023732,703471,320261,2021-10-01 18:21:14
7686,28,Punjab,19595089,14543687,5051402,2021-10-01 18:21:14
7687,29,Rajasthan,56373041,40553626,15819415,2021-10-01 18:21:14
7688,30,Sikkim,912325,518638,393687,2021-10-01 18:21:14
7689,31,Tamil Nadu,47507210,36159579,11347631,2021-10-01 18:21:14
7690,32,Telangana,26005116,18870374,7134742,2021-10-01 18:21:14
7691,33,Tripura,3901423,2496257,1405166,2021-10-01 18:21:14
7692,34,Uttar Pradesh,108813190,87416553,21396637,2021-10-01 18:21:14
7693,35,Uttarakhand,10534912,7367930,3166982,2021-10-01 18:21:14
7694,36,West Bengal,58401332,41545724,16855608,2021-10-01 18:21:14
7695,37,Daman and Diu,418541,266065,152476,2021-10-01 18:21:14
7696,1,Andaman and Nicobar Islands,444294,289983,154311,2021-10-02 18:18:44
7697,2,Andhra Pradesh,42200806,27997965,14202841,2021-10-02 18:18:44
7698,3,Arunachal Pradesh,1183937,757150,426787,2021-10-02 18:18:44
7699,4,Assam,24788751,18867868,5920883,2021-10-02 18:18:44
7700,5,Bihar,57244209,45067241,12176968,2021-10-02 18:18:44
7701,6,Chandigarh,1362067,904205,457862,2021-10-02 18:18:44
7702,7,Chhattisgarh,17951779,12588252,5363527,2021-10-02 18:18:44
7703,8,Dadra and Nagar Haveli,513318,380801,132517,2021-10-02 18:18:44
7704,9,Delhi,18202932,12198840,6004092,2021-10-02 18:18:44
7705,10,Goa,1948746,1229753,718993,2021-10-02 18:18:44
7706,11,Gujarat,61391139,42186528,19204611,2021-10-02 18:18:44
7707,12,Haryana,23354304,16817088,6537216,2021-10-02 18:18:44
7708,13,Himachal Pradesh,8444392,5666027,2778365,2021-10-02 18:18:44
7709,14,Jammu and Kashmir,11773434,8128981,3644453,2021-10-02 18:18:44
7710,15,Jharkhand,17969746,13751889,4217857,2021-10-02 18:18:44
7711,16,Karnataka,56904216,39424340,17479876,2021-10-02 18:18:44
7712,17,Kerala,35867136,24747610,11119526,2021-10-02 18:18:44
7713,18,Ladakh,344318,205555,138763,2021-10-02 18:18:44
7714,19,Lakshadweep,96936,54845,42091,2021-10-02 18:18:44
7715,20,Madhya Pradesh,63922744,48597461,15325283,2021-10-02 18:18:44
7716,21,Maharashtra,83524276,58548458,24975818,2021-10-02 18:18:44
7717,22,Manipur,1718870,1225811,493059,2021-10-02 18:18:44
7718,23,Meghalaya,1554203,1073325,480878,2021-10-02 18:18:44
7719,24,Mizoram,1144299,697797,446502,2021-10-02 18:18:44
7720,25,Nagaland,1062985,688453,374532,2021-10-02 18:18:44
7721,26,Odisha,31202475,22467640,8734835,2021-10-02 18:18:44
7722,27,Puducherry,1027839,704714,323125,2021-10-02 18:18:44
7723,28,Punjab,19615038,14555131,5059907,2021-10-02 18:18:44
7724,29,Rajasthan,56607258,40649805,15957453,2021-10-02 18:18:44
7725,30,Sikkim,913506,518698,394808,2021-10-02 18:18:44
7726,31,Tamil Nadu,47684644,36252084,11432560,2021-10-02 18:18:44
7727,32,Telangana,26329795,19098097,7231698,2021-10-02 18:18:44
7728,33,Tripura,3906769,2496515,1410254,2021-10-02 18:18:44
7729,34,Uttar Pradesh,109149090,87501967,21647123,2021-10-02 18:18:44
7730,35,Uttarakhand,10559641,7373069,3186572,2021-10-02 18:18:44
7731,36,West Bengal,58700910,41767547,16933363,2021-10-02 18:18:44
7732,37,Daman and Diu,418688,266074,152614,2021-10-02 18:18:44
7733,1,Andaman and Nicobar Islands,444347,289999,154348,2021-10-03 18:19:50
7734,2,Andhra Pradesh,42280401,28049011,14231390,2021-10-03 18:19:50
7735,3,Arunachal Pradesh,1184655,757188,427467,2021-10-03 18:19:50
7736,4,Assam,24833120,18895892,5937228,2021-10-03 18:19:50
7737,5,Bihar,57553783,45219982,12333801,2021-10-03 18:19:50
7738,6,Chandigarh,1365873,905179,460694,2021-10-03 18:19:50
7739,7,Chhattisgarh,17976248,12597798,5378450,2021-10-03 18:19:50
7740,8,Dadra and Nagar Haveli,514295,380955,133340,2021-10-03 18:19:50
7741,9,Delhi,18221369,12206307,6015062,2021-10-03 18:19:50
7742,10,Goa,1957536,1230959,726577,2021-10-03 18:19:50
7743,11,Gujarat,61448038,42217358,19230680,2021-10-03 18:19:50
7744,12,Haryana,23399727,16840190,6559537,2021-10-03 18:19:50
7745,13,Himachal Pradesh,8448321,5666290,2782031,2021-10-03 18:19:50
7746,14,Jammu and Kashmir,11909047,8226199,3682848,2021-10-03 18:19:50
7747,15,Jharkhand,18076786,13813288,4263498,2021-10-03 18:19:50
7748,16,Karnataka,56941569,39438744,17502825,2021-10-03 18:19:50
7749,17,Kerala,35877273,24750569,11126704,2021-10-03 18:19:50
7750,18,Ladakh,344318,205555,138763,2021-10-03 18:19:50
7751,19,Lakshadweep,97108,54846,42262,2021-10-03 18:19:50
7752,20,Madhya Pradesh,63974918,48622672,15352246,2021-10-03 18:19:50
7753,21,Maharashtra,83650886,58616814,25034072,2021-10-03 18:19:50
7754,22,Manipur,1720196,1226050,494146,2021-10-03 18:19:50
7755,23,Meghalaya,1554484,1073366,481118,2021-10-03 18:19:50
7756,24,Mizoram,1144299,697797,446502,2021-10-03 18:19:50
7757,25,Nagaland,1065156,688632,376524,2021-10-03 18:19:50
7758,26,Odisha,31244904,22491954,8752950,2021-10-03 18:19:50
7759,27,Puducherry,1030149,705356,324793,2021-10-03 18:19:50
7760,28,Punjab,19626022,14560256,5065766,2021-10-03 18:19:50
7761,29,Rajasthan,56666817,40671136,15995681,2021-10-03 18:19:50
7762,30,Sikkim,913506,518698,394808,2021-10-03 18:19:50
7763,31,Tamil Nadu,49133554,37070227,12063327,2021-10-03 18:19:50
7764,32,Telangana,26390426,19141599,7248827,2021-10-03 18:19:50
7765,33,Tripura,3907919,2496558,1411361,2021-10-03 18:19:50
7766,34,Uttar Pradesh,109190079,87525999,21664080,2021-10-03 18:19:50
7767,35,Uttarakhand,10571714,7375336,3196378,2021-10-03 18:19:50
7768,36,West Bengal,58798354,41837806,16960548,2021-10-03 18:19:50
7769,37,Daman and Diu,418688,266074,152614,2021-10-03 18:19:50
7770,1,Andaman and Nicobar Islands,447289,290292,156997,2021-10-04 18:11:52
7771,2,Andhra Pradesh,42649922,28255444,14394478,2021-10-04 18:11:52
7772,3,Arunachal Pradesh,1194637,758512,436125,2021-10-04 18:11:52
7773,4,Assam,24967215,18962761,6004454,2021-10-04 18:11:52
7774,5,Bihar,58067948,45511161,12556787,2021-10-04 18:11:52
7775,6,Chandigarh,1372763,907007,465756,2021-10-04 18:11:52
7776,7,Chhattisgarh,18212452,12712319,5500133,2021-10-04 18:11:52
7777,8,Dadra and Nagar Haveli,518742,381527,137215,2021-10-04 18:11:52
7778,9,Delhi,18394082,12277755,6116327,2021-10-04 18:11:52
7779,10,Goa,1968969,1232874,736095,2021-10-04 18:11:52
7780,11,Gujarat,62049821,42431382,19618439,2021-10-04 18:11:52
7781,12,Haryana,23506642,16892761,6613881,2021-10-04 18:11:52
7782,13,Himachal Pradesh,8486399,5669165,2817234,2021-10-04 18:11:52
7783,14,Jammu and Kashmir,12081798,8340635,3741163,2021-10-04 18:11:52
7784,15,Jharkhand,18215047,13892221,4322826,2021-10-04 18:11:52
7785,16,Karnataka,57166437,39518355,17648082,2021-10-04 18:11:52
7786,17,Kerala,36057622,24791634,11265988,2021-10-04 18:11:52
7787,18,Ladakh,345637,205908,139729,2021-10-04 18:11:52
7788,19,Lakshadweep,97365,54891,42474,2021-10-04 18:11:52
7789,20,Madhya Pradesh,64314773,48731333,15583440,2021-10-04 18:11:52
7790,21,Maharashtra,84192306,58905902,25286404,2021-10-04 18:11:52
7791,22,Manipur,1731639,1227361,504278,2021-10-04 18:11:52
7792,23,Meghalaya,1563685,1074750,488935,2021-10-04 18:11:52
7793,24,Mizoram,1148044,698230,449814,2021-10-04 18:11:52
7794,25,Nagaland,1072774,689883,382891,2021-10-04 18:11:52
7795,26,Odisha,31632681,22722336,8910345,2021-10-04 18:11:52
7796,27,Puducherry,1037401,707459,329942,2021-10-04 18:11:52
7797,28,Punjab,19863224,14694332,5168892,2021-10-04 18:11:52
7798,29,Rajasthan,56788760,40718752,16070008,2021-10-04 18:11:52
7799,30,Sikkim,918045,518936,399109,2021-10-04 18:11:52
7800,31,Tamil Nadu,49352875,37187192,12165683,2021-10-04 18:11:52
7801,32,Telangana,26725507,19369102,7356405,2021-10-04 18:11:52
7802,33,Tripura,3928758,2497695,1431063,2021-10-04 18:11:52
7803,34,Uttar Pradesh,110855655,88554151,22301504,2021-10-04 18:11:52
7804,35,Uttarakhand,10609974,7383649,3226325,2021-10-04 18:11:52
7805,36,West Bengal,59365277,42243166,17122111,2021-10-04 18:11:52
7806,37,Daman and Diu,422814,266626,156188,2021-10-04 18:11:52
7807,1,Andaman and Nicobar Islands,449767,290553,159214,2021-10-05 18:21:07
7808,2,Andhra Pradesh,42822204,28327473,14494731,2021-10-05 18:21:07
7809,3,Arunachal Pradesh,1202280,759530,442750,2021-10-05 18:21:07
7810,4,Assam,25103588,19033219,6070369,2021-10-05 18:21:07
7811,5,Bihar,58684101,45871181,12812920,2021-10-05 18:21:07
7812,6,Chandigarh,1378177,908493,469684,2021-10-05 18:21:07
7813,7,Chhattisgarh,18366781,12787183,5579598,2021-10-05 18:21:07
7814,8,Dadra and Nagar Haveli,523254,382073,141181,2021-10-05 18:21:07
7815,9,Delhi,18547832,12337876,6209956,2021-10-05 18:21:07
7816,10,Goa,1979687,1234383,745304,2021-10-05 18:21:07
7817,11,Gujarat,62554408,42611419,19942989,2021-10-05 18:21:07
7818,12,Haryana,23620422,16948544,6671878,2021-10-05 18:21:07
7819,13,Himachal Pradesh,8516418,5671739,2844679,2021-10-05 18:21:07
7820,14,Jammu and Kashmir,12254305,8459196,3795109,2021-10-05 18:21:07
7821,15,Jharkhand,18337629,13962685,4374944,2021-10-05 18:21:07
7822,16,Karnataka,57419569,39606394,17813175,2021-10-05 18:21:07
7823,17,Kerala,36206160,24825093,11381067,2021-10-05 18:21:07
7824,18,Ladakh,346636,206089,140547,2021-10-05 18:21:07
7825,19,Lakshadweep,97579,54919,42660,2021-10-05 18:21:07
7826,20,Madhya Pradesh,64439156,48774967,15664189,2021-10-05 18:21:07
7827,21,Maharashtra,84646779,59147689,25499090,2021-10-05 18:21:07
7828,22,Manipur,1739856,1228110,511746,2021-10-05 18:21:07
7829,23,Meghalaya,1572992,1076048,496944,2021-10-05 18:21:07
7830,24,Mizoram,1153450,699126,454324,2021-10-05 18:21:07
7831,25,Nagaland,1079727,691087,388640,2021-10-05 18:21:07
7832,26,Odisha,31969449,22930855,9038594,2021-10-05 18:21:07
7833,27,Puducherry,1040304,708244,332060,2021-10-05 18:21:07
7834,28,Punjab,20086809,14823124,5263685,2021-10-05 18:21:07
7835,29,Rajasthan,56998552,40794706,16203846,2021-10-05 18:21:07
7836,30,Sikkim,919801,519029,400772,2021-10-05 18:21:07
7837,31,Tamil Nadu,49548432,37283506,12264926,2021-10-05 18:21:07
7838,32,Telangana,26960881,19530027,7430854,2021-10-05 18:21:07
7839,33,Tripura,3949642,2498589,1451053,2021-10-05 18:21:07
7840,34,Uttar Pradesh,111731239,89046011,22685228,2021-10-05 18:21:07
7841,35,Uttarakhand,10641271,7390445,3250826,2021-10-05 18:21:07
7842,36,West Bengal,60382222,43072567,17309655,2021-10-05 18:21:07
7843,37,Daman and Diu,425695,267132,158563,2021-10-05 18:21:07
7844,1,Andaman and Nicobar Islands,452384,290843,161541,2021-10-06 18:19:20
7845,2,Andhra Pradesh,42942600,28375351,14567249,2021-10-06 18:19:20
7846,3,Arunachal Pradesh,1208728,760409,448319,2021-10-06 18:19:20
7847,4,Assam,25216927,19105608,6111319,2021-10-06 18:19:20
7848,5,Bihar,59228889,46185407,13043482,2021-10-06 18:19:20
7849,6,Chandigarh,1382714,909730,472984,2021-10-06 18:19:20
7850,7,Chhattisgarh,18489320,12842921,5646399,2021-10-06 18:19:20
7851,8,Dadra and Nagar Haveli,525833,382505,143328,2021-10-06 18:19:20
7852,9,Delhi,18659191,12381420,6277771,2021-10-06 18:19:20
7853,10,Goa,1988100,1235627,752473,2021-10-06 18:19:20
7854,11,Gujarat,62882433,42730263,20152170,2021-10-06 18:19:20
7855,12,Haryana,23698478,16985374,6713104,2021-10-06 18:19:20
7856,13,Himachal Pradesh,8540175,5673924,2866251,2021-10-06 18:19:20
7857,14,Jammu and Kashmir,12426098,8585919,3840179,2021-10-06 18:19:20
7858,15,Jharkhand,18463151,14035825,4427326,2021-10-06 18:19:20
7859,16,Karnataka,57513806,39645064,17868742,2021-10-06 18:19:20
7860,17,Kerala,36298609,24853783,11444826,2021-10-06 18:19:20
7861,18,Ladakh,347529,206400,141129,2021-10-06 18:19:20
7862,19,Lakshadweep,97845,54929,42916,2021-10-06 18:19:20
7863,20,Madhya Pradesh,64607273,48819960,15787313,2021-10-06 18:19:20
7864,21,Maharashtra,85193200,59460947,25732253,2021-10-06 18:19:20
7865,22,Manipur,1749453,1229107,520346,2021-10-06 18:19:20
7866,23,Meghalaya,1580263,1077265,502998,2021-10-06 18:19:20
7867,24,Mizoram,1157504,699641,457863,2021-10-06 18:19:20
7868,25,Nagaland,1086902,692082,394820,2021-10-06 18:19:20
7869,26,Odisha,32149343,23028237,9121106,2021-10-06 18:19:20
7870,27,Puducherry,1044869,709565,335304,2021-10-06 18:19:20
7871,28,Punjab,20184934,14879112,5305822,2021-10-06 18:19:20
7872,29,Rajasthan,57608801,41016799,16592002,2021-10-06 18:19:20
7873,30,Sikkim,924131,519270,404861,2021-10-06 18:19:20
7874,31,Tamil Nadu,49694955,37354879,12340076,2021-10-06 18:19:20
7875,32,Telangana,26980097,19541498,7438599,2021-10-06 18:19:20
7876,33,Tripura,3951598,2498632,1452966,2021-10-06 18:19:20
7877,34,Uttar Pradesh,112152178,89257887,22894291,2021-10-06 18:19:20
7878,35,Uttarakhand,10664319,7395444,3268875,2021-10-06 18:19:20
7879,36,West Bengal,60745262,43354795,17390467,2021-10-06 18:19:20
7880,37,Daman and Diu,427882,267526,160356,2021-10-06 18:19:20
7881,1,Andaman and Nicobar Islands,454459,291041,163418,2021-10-07 18:18:41
7882,2,Andhra Pradesh,43130645,28460133,14670512,2021-10-07 18:18:41
7883,3,Arunachal Pradesh,1216112,761364,454748,2021-10-07 18:18:41
7884,4,Assam,25407781,19218050,6189731,2021-10-07 18:18:41
7885,5,Bihar,59475960,46321493,13154467,2021-10-07 18:18:41
7886,6,Chandigarh,1386277,910666,475611,2021-10-07 18:18:41
7887,7,Chhattisgarh,18638334,12913629,5724705,2021-10-07 18:18:41
7888,8,Dadra and Nagar Haveli,528445,382830,145615,2021-10-07 18:18:41
7889,9,Delhi,18749975,12417663,6332312,2021-10-07 18:18:41
7890,10,Goa,1995557,1236761,758796,2021-10-07 18:18:41
7891,11,Gujarat,63363019,42891173,20471846,2021-10-07 18:18:41
7892,12,Haryana,23755478,17013870,6741608,2021-10-07 18:18:41
7893,13,Himachal Pradesh,8562587,5675971,2886616,2021-10-07 18:18:41
7894,14,Jammu and Kashmir,12607785,8723901,3883884,2021-10-07 18:18:41
7895,15,Jharkhand,18554546,14088240,4466306,2021-10-07 18:18:41
7896,16,Karnataka,57661070,39694400,17966670,2021-10-07 18:18:41
7897,17,Kerala,36437151,24891342,11545809,2021-10-07 18:18:41
7898,18,Ladakh,348644,206599,142045,2021-10-07 18:18:41
7899,19,Lakshadweep,98023,54946,43077,2021-10-07 18:18:41
7900,20,Madhya Pradesh,64829189,48876088,15953101,2021-10-07 18:18:41
7901,21,Maharashtra,85667080,59723914,25943166,2021-10-07 18:18:41
7902,22,Manipur,1753827,1229462,524365,2021-10-07 18:18:41
7903,23,Meghalaya,1588822,1078698,510124,2021-10-07 18:18:41
7904,24,Mizoram,1163734,700477,463257,2021-10-07 18:18:41
7905,25,Nagaland,1093079,693007,400072,2021-10-07 18:18:41
7906,26,Odisha,32295431,23099094,9196337,2021-10-07 18:18:41
7907,27,Puducherry,1048949,710695,338254,2021-10-07 18:18:41
7908,28,Punjab,20287181,14941604,5345577,2021-10-07 18:18:41
7909,29,Rajasthan,57710161,41053611,16656550,2021-10-07 18:18:41
7910,30,Sikkim,929512,519617,409895,2021-10-07 18:18:41
7911,31,Tamil Nadu,49862303,37436033,12426270,2021-10-07 18:18:41
7912,32,Telangana,27290402,19745485,7544917,2021-10-07 18:18:41
7913,33,Tripura,3971050,2499673,1471377,2021-10-07 18:18:41
7914,34,Uttar Pradesh,112787516,89608699,23178817,2021-10-07 18:18:41
7915,35,Uttarakhand,10681777,7399465,3282312,2021-10-07 18:18:41
7916,36,West Bengal,61897368,44315122,17582246,2021-10-07 18:18:41
7917,37,Daman and Diu,429693,267808,161885,2021-10-07 18:18:41
7918,1,Andaman and Nicobar Islands,456250,291237,165013,2021-10-08 18:21:51
7919,2,Andhra Pradesh,43828216,28787311,15040905,2021-10-08 18:21:51
7920,3,Arunachal Pradesh,1222331,762052,460279,2021-10-08 18:21:51
7921,4,Assam,25561950,19315962,6245988,2021-10-08 18:21:51
7922,5,Bihar,59793858,46489573,13304285,2021-10-08 18:21:51
7923,6,Chandigarh,1390768,911698,479070,2021-10-08 18:21:51
7924,7,Chhattisgarh,18765018,12973147,5791871,2021-10-08 18:21:51
7925,8,Dadra and Nagar Haveli,531958,383269,148689,2021-10-08 18:21:51
7926,9,Delhi,18857482,12457407,6400075,2021-10-08 18:21:51
7927,10,Goa,2004217,1238037,766180,2021-10-08 18:21:51
7928,11,Gujarat,63787658,43024346,20763312,2021-10-08 18:21:51
7929,12,Haryana,23880044,17070619,6809425,2021-10-08 18:21:51
7930,13,Himachal Pradesh,8582221,5677721,2904500,2021-10-08 18:21:51
7931,14,Jammu and Kashmir,12778974,8854040,3924934,2021-10-08 18:21:51
7932,15,Jharkhand,18676483,14159593,4516890,2021-10-08 18:21:51
7933,16,Karnataka,58601989,40036620,18565369,2021-10-08 18:21:51
7934,17,Kerala,36552416,24924390,11628026,2021-10-08 18:21:51
7935,18,Ladakh,350017,206804,143213,2021-10-08 18:21:51
7936,19,Lakshadweep,98277,54962,43315,2021-10-08 18:21:51
7937,20,Madhya Pradesh,64970285,48924966,16045319,2021-10-08 18:21:51
7938,21,Maharashtra,86421502,60160092,26261410,2021-10-08 18:21:51
7939,22,Manipur,1764929,1230350,534579,2021-10-08 18:21:51
7940,23,Meghalaya,1596669,1080077,516592,2021-10-08 18:21:51
7941,24,Mizoram,1170040,701235,468805,2021-10-08 18:21:51
7942,25,Nagaland,1100026,694254,405772,2021-10-08 18:21:51
7943,26,Odisha,32437414,23165869,9271545,2021-10-08 18:21:51
7944,27,Puducherry,1054027,712144,341883,2021-10-08 18:21:51
7945,28,Punjab,20431201,15020996,5410205,2021-10-08 18:21:51
7946,29,Rajasthan,58166044,41218940,16947104,2021-10-08 18:21:51
7947,30,Sikkim,933899,519852,414047,2021-10-08 18:21:51
7948,31,Tamil Nadu,50023506,37511267,12512239,2021-10-08 18:21:51
7949,32,Telangana,27560591,19922452,7638139,2021-10-08 18:21:51
7950,33,Tripura,3975530,2499853,1475677,2021-10-08 18:21:51
7951,34,Uttar Pradesh,114508989,90618118,23890871,2021-10-08 18:21:51
7952,35,Uttarakhand,10714462,7405953,3308509,2021-10-08 18:21:51
7953,36,West Bengal,62828032,45066608,17761424,2021-10-08 18:21:51
7954,37,Daman and Diu,431593,268066,163527,2021-10-08 18:21:51
7955,1,Andaman and Nicobar Islands,458008,291404,166604,2021-10-09 18:11:48
7956,2,Andhra Pradesh,44430919,29037107,15393812,2021-10-09 18:11:48
7957,3,Arunachal Pradesh,1227537,762665,464872,2021-10-09 18:11:48
7958,4,Assam,25801476,19456135,6345341,2021-10-09 18:11:48
7959,5,Bihar,60396500,46777203,13619297,2021-10-09 18:11:48
7960,6,Chandigarh,1397532,913084,484448,2021-10-09 18:11:48
7961,7,Chhattisgarh,18943466,13056542,5886924,2021-10-09 18:11:48
7962,8,Dadra and Nagar Haveli,535242,383615,151627,2021-10-09 18:11:48
7963,9,Delhi,19011846,12511987,6499859,2021-10-09 18:11:48
7964,10,Goa,2015170,1239741,775429,2021-10-09 18:11:48
7965,11,Gujarat,64188451,43149771,21038680,2021-10-09 18:11:48
7966,12,Haryana,23989650,17119989,6869661,2021-10-09 18:11:48
7967,13,Himachal Pradesh,8599506,5679157,2920349,2021-10-09 18:11:48
7968,14,Jammu and Kashmir,12924142,8952667,3971475,2021-10-09 18:11:48
7969,15,Jharkhand,18766684,14208682,4558002,2021-10-09 18:11:48
7970,16,Karnataka,58815389,40108996,18706393,2021-10-09 18:11:48
7971,17,Kerala,36605138,24937637,11667501,2021-10-09 18:11:48
7972,18,Ladakh,350828,206959,143869,2021-10-09 18:11:48
7973,19,Lakshadweep,98514,54971,43543,2021-10-09 18:11:48
7974,20,Madhya Pradesh,65214635,48980871,16233764,2021-10-09 18:11:48
7975,21,Maharashtra,87285473,60647926,26637547,2021-10-09 18:11:48
7976,22,Manipur,1770751,1230951,539800,2021-10-09 18:11:48
7977,23,Meghalaya,1603494,1081154,522340,2021-10-09 18:11:48
7978,24,Mizoram,1170585,701290,469295,2021-10-09 18:11:48
7979,25,Nagaland,1101516,694478,407038,2021-10-09 18:11:48
7980,26,Odisha,32672363,23295494,9376869,2021-10-09 18:11:48
7981,27,Puducherry,1059374,713552,345822,2021-10-09 18:11:48
7982,28,Punjab,20594227,15115696,5478531,2021-10-09 18:11:48
7983,29,Rajasthan,58645849,41387835,17258014,2021-10-09 18:11:48
7984,30,Sikkim,936368,519996,416372,2021-10-09 18:11:48
7985,31,Tamil Nadu,50163833,37577012,12586821,2021-10-09 18:11:48
7986,32,Telangana,27820483,20085961,7734522,2021-10-09 18:11:48
7987,33,Tripura,3986810,2500448,1486362,2021-10-09 18:11:48
7988,34,Uttar Pradesh,115018226,90775267,24242959,2021-10-09 18:11:48
7989,35,Uttarakhand,10738615,7410674,3327941,2021-10-09 18:11:48
7990,36,West Bengal,64147566,46196142,17951424,2021-10-09 18:11:48
7991,37,Daman and Diu,433808,268368,165440,2021-10-09 18:11:48
7992,1,Andaman and Nicobar Islands,458156,291423,166733,2021-10-10 18:21:36
7993,2,Andhra Pradesh,44565559,29099128,15466431,2021-10-10 18:21:36
7994,3,Arunachal Pradesh,1228623,762870,465753,2021-10-10 18:21:36
7995,4,Assam,25969059,19564092,6404967,2021-10-10 18:21:36
7996,5,Bihar,60561119,46857780,13703339,2021-10-10 18:21:36
7997,6,Chandigarh,1400557,913737,486820,2021-10-10 18:21:36
7998,7,Chhattisgarh,19024088,13094911,5929177,2021-10-10 18:21:36
7999,8,Dadra and Nagar Haveli,535746,383676,152070,2021-10-10 18:21:36
8000,9,Delhi,19059769,12536220,6523549,2021-10-10 18:21:36
8001,10,Goa,2022132,1240661,781471,2021-10-10 18:21:36
8002,11,Gujarat,65146339,43504122,21642217,2021-10-10 18:21:36
8003,12,Haryana,24031510,17138958,6892552,2021-10-10 18:21:36
8004,13,Himachal Pradesh,8601361,5679341,2922020,2021-10-10 18:21:36
8005,14,Jammu and Kashmir,13062089,9062906,3999183,2021-10-10 18:21:36
8006,15,Jharkhand,18850006,14254936,4595070,2021-10-10 18:21:36
8007,16,Karnataka,59024478,40183873,18840605,2021-10-10 18:21:36
8008,17,Kerala,36619017,24941753,11677264,2021-10-10 18:21:36
8009,18,Ladakh,350848,206966,143882,2021-10-10 18:21:36
8010,19,Lakshadweep,98582,54977,43605,2021-10-10 18:21:36
8011,20,Madhya Pradesh,65245913,48987997,16257916,2021-10-10 18:21:36
8012,21,Maharashtra,87717416,60923427,26793989,2021-10-10 18:21:36
8013,22,Manipur,1773004,1231250,541754,2021-10-10 18:21:36
8014,23,Meghalaya,1603790,1081198,522592,2021-10-10 18:21:36
8015,24,Mizoram,1170741,701296,469445,2021-10-10 18:21:36
8016,25,Nagaland,1104101,694747,409354,2021-10-10 18:21:36
8017,26,Odisha,32705619,23313250,9392369,2021-10-10 18:21:36
8018,27,Puducherry,1061083,713969,347114,2021-10-10 18:21:36
8019,28,Punjab,20641352,15140480,5500872,2021-10-10 18:21:36
8020,29,Rajasthan,58916819,41475222,17441597,2021-10-10 18:21:36
8021,30,Sikkim,936368,519996,416372,2021-10-10 18:21:36
8022,31,Tamil Nadu,51928816,38473926,13454890,2021-10-10 18:21:36
8023,32,Telangana,27840851,20099225,7741626,2021-10-10 18:21:36
8024,33,Tripura,3987428,2500502,1486926,2021-10-10 18:21:36
8025,34,Uttar Pradesh,115079166,90809111,24270055,2021-10-10 18:21:36
8026,35,Uttarakhand,10749001,7412361,3336640,2021-10-10 18:21:36
8027,36,West Bengal,64406006,46416260,17989746,2021-10-10 18:21:36
8028,37,Daman and Diu,433808,268368,165440,2021-10-10 18:21:36
8029,1,Andaman and Nicobar Islands,459725,291635,168090,2021-10-11 18:21:05
8030,2,Andhra Pradesh,44968021,29269614,15698407,2021-10-11 18:21:05
8031,3,Arunachal Pradesh,1236901,763855,473046,2021-10-11 18:21:05
8032,4,Assam,26163665,19673799,6489866,2021-10-11 18:21:05
8033,5,Bihar,61076840,47093682,13983158,2021-10-11 18:21:05
8034,6,Chandigarh,1405022,914824,490198,2021-10-11 18:21:05
8035,7,Chhattisgarh,19178382,13165236,6013146,2021-10-11 18:21:05
8036,8,Dadra and Nagar Haveli,538496,384097,154399,2021-10-11 18:21:05
8037,9,Delhi,19188993,12588815,6600178,2021-10-11 18:21:05
8038,10,Goa,2031062,1242052,789010,2021-10-11 18:21:05
8039,11,Gujarat,65415873,43590533,21825340,2021-10-11 18:21:05
8040,12,Haryana,24127775,17181326,6946449,2021-10-11 18:21:05
8041,13,Himachal Pradesh,8622510,5681174,2941336,2021-10-11 18:21:05
8042,14,Jammu and Kashmir,13201403,9156268,4045135,2021-10-11 18:21:05
8043,15,Jharkhand,18942818,14308332,4634486,2021-10-11 18:21:05
8044,16,Karnataka,59467194,40325648,19141546,2021-10-11 18:21:05
8045,17,Kerala,36762354,24980138,11782216,2021-10-11 18:21:05
8046,18,Ladakh,351430,207127,144303,2021-10-11 18:21:05
8047,19,Lakshadweep,98783,54994,43789,2021-10-11 18:21:05
8048,20,Madhya Pradesh,65464779,49021462,16443317,2021-10-11 18:21:05
8049,21,Maharashtra,88544662,61441549,27103113,2021-10-11 18:21:05
8050,22,Manipur,1786307,1232338,553969,2021-10-11 18:21:05
8051,23,Meghalaya,1612078,1082436,529642,2021-10-11 18:21:05
8052,24,Mizoram,1176291,702292,473999,2021-10-11 18:21:05
8053,25,Nagaland,1112841,696061,416780,2021-10-11 18:21:05
8054,26,Odisha,33048334,23519024,9529310,2021-10-11 18:21:05
8055,27,Puducherry,1067058,715548,351510,2021-10-11 18:21:05
8056,28,Punjab,20755580,15205422,5550158,2021-10-11 18:21:05
8057,29,Rajasthan,59199481,41563118,17636363,2021-10-11 18:21:05
8058,30,Sikkim,939075,520150,418925,2021-10-11 18:21:05
8059,31,Tamil Nadu,52197086,38609535,13587551,2021-10-11 18:21:05
8060,32,Telangana,28067824,20237740,7830084,2021-10-11 18:21:05
8061,33,Tripura,3994387,2500997,1493390,2021-10-11 18:21:05
8062,34,Uttar Pradesh,116542748,91650918,24891830,2021-10-11 18:21:05
8063,35,Uttarakhand,10779950,7417975,3361975,2021-10-11 18:21:05
8064,36,West Bengal,64917115,46838304,18078811,2021-10-11 18:21:05
8065,37,Daman and Diu,435869,268629,167240,2021-10-11 18:21:05
8066,1,Andaman and Nicobar Islands,461846,291867,169979,2021-10-12 18:22:03
8067,2,Andhra Pradesh,45468542,29509076,15959466,2021-10-12 18:22:03
8068,3,Arunachal Pradesh,1241123,764363,476760,2021-10-12 18:22:03
8069,4,Assam,26191700,19690295,6501405,2021-10-12 18:22:03
8070,5,Bihar,61247500,47168303,14079197,2021-10-12 18:22:03
8071,6,Chandigarh,1408702,915613,493089,2021-10-12 18:22:03
8072,7,Chhattisgarh,19282079,13207355,6074724,2021-10-12 18:22:03
8073,8,Dadra and Nagar Haveli,541852,384431,157421,2021-10-12 18:22:03
8074,9,Delhi,19290949,12630066,6660883,2021-10-12 18:22:03
8075,10,Goa,2039235,1243250,795985,2021-10-12 18:22:03
8076,11,Gujarat,65745633,43693218,22052415,2021-10-12 18:22:03
8077,12,Haryana,24267213,17241086,7026127,2021-10-12 18:22:03
8078,13,Himachal Pradesh,8646777,5683050,2963727,2021-10-12 18:22:03
8079,14,Jammu and Kashmir,13340374,9242855,4097519,2021-10-12 18:22:03
8080,15,Jharkhand,19003656,14337776,4665880,2021-10-12 18:22:03
8081,16,Karnataka,59912290,40472970,19439320,2021-10-12 18:22:03
8082,17,Kerala,36896498,25011531,11884967,2021-10-12 18:22:03
8083,18,Ladakh,352392,207249,145143,2021-10-12 18:22:03
8084,19,Lakshadweep,98932,55001,43931,2021-10-12 18:22:03
8085,20,Madhya Pradesh,65639776,49054445,16585331,2021-10-12 18:22:03
8086,21,Maharashtra,89331470,61950076,27381394,2021-10-12 18:22:03
8087,22,Manipur,1795051,1233125,561926,2021-10-12 18:22:03
8088,23,Meghalaya,1620729,1083870,536859,2021-10-12 18:22:03
8089,24,Mizoram,1181905,702750,479155,2021-10-12 18:22:03
8090,25,Nagaland,1121007,697538,423469,2021-10-12 18:22:03
8091,26,Odisha,33330227,23693379,9636848,2021-10-12 18:22:03
8092,27,Puducherry,1071207,716593,354614,2021-10-12 18:22:03
8093,28,Punjab,20859097,15265783,5593314,2021-10-12 18:22:03
8094,29,Rajasthan,59468613,41647885,17820728,2021-10-12 18:22:03
8095,30,Sikkim,940936,520231,420705,2021-10-12 18:22:03
8096,31,Tamil Nadu,52376601,38694181,13682420,2021-10-12 18:22:03
8097,32,Telangana,28306599,20393627,7912972,2021-10-12 18:22:03
8098,33,Tripura,3994882,2501022,1493860,2021-10-12 18:22:03
8099,34,Uttar Pradesh,117159115,91974814,25184301,2021-10-12 18:22:03
8100,35,Uttarakhand,10803381,7421381,3382000,2021-10-12 18:22:03
8101,36,West Bengal,65502321,47381267,18121054,2021-10-12 18:22:03
8102,37,Daman and Diu,437220,268827,168393,2021-10-12 18:22:03
8103,1,Andaman and Nicobar Islands,462766,292066,170700,2021-10-13 18:07:33
8104,2,Andhra Pradesh,45874836,29690101,16184735,2021-10-13 18:07:33
8105,3,Arunachal Pradesh,1245324,764844,480480,2021-10-13 18:07:33
8106,4,Assam,26200110,19693895,6506215,2021-10-13 18:07:33
8107,5,Bihar,61326396,47199534,14126862,2021-10-13 18:07:33
8108,6,Chandigarh,1412009,916397,495612,2021-10-13 18:07:33
8109,7,Chhattisgarh,19366269,13240867,6125402,2021-10-13 18:07:33
8110,8,Dadra and Nagar Haveli,543441,384687,158754,2021-10-13 18:07:33
8111,9,Delhi,19365564,12660057,6705507,2021-10-13 18:07:33
8112,10,Goa,2046459,1244336,802123,2021-10-13 18:07:33
8113,11,Gujarat,66017857,43783462,22234395,2021-10-13 18:07:33
8114,12,Haryana,24407351,17295587,7111764,2021-10-13 18:07:33
8115,13,Himachal Pradesh,8666710,5684767,2981943,2021-10-13 18:07:33
8116,14,Jammu and Kashmir,13449399,9304167,4145232,2021-10-13 18:07:33
8117,15,Jharkhand,19031630,14351586,4680044,2021-10-13 18:07:33
8118,16,Karnataka,60432276,40659523,19772753,2021-10-13 18:07:33
8119,17,Kerala,36969392,25029319,11940073,2021-10-13 18:07:33
8120,18,Ladakh,353415,207342,146073,2021-10-13 18:07:33
8121,19,Lakshadweep,99117,55011,44106,2021-10-13 18:07:33
8122,20,Madhya Pradesh,65808372,49081043,16727329,2021-10-13 18:07:33
8123,21,Maharashtra,90052667,62434421,27618246,2021-10-13 18:07:33
8124,22,Manipur,1800632,1233800,566832,2021-10-13 18:07:33
8125,23,Meghalaya,1626931,1085007,541924,2021-10-13 18:07:33
8126,24,Mizoram,1185912,703064,482848,2021-10-13 18:07:33
8127,25,Nagaland,1128886,698807,430079,2021-10-13 18:07:33
8128,26,Odisha,33544107,23826446,9717661,2021-10-13 18:07:33
8129,27,Puducherry,1073892,717329,356563,2021-10-13 18:07:33
8130,28,Punjab,20938851,15310693,5628158,2021-10-13 18:07:33
8131,29,Rajasthan,59567442,41675134,17892308,2021-10-13 18:07:33
8132,30,Sikkim,941250,520253,420997,2021-10-13 18:07:33
8133,31,Tamil Nadu,52527782,38765198,13762584,2021-10-13 18:07:33
8134,32,Telangana,28456270,20496725,7959545,2021-10-13 18:07:33
8135,33,Tripura,3994886,2501022,1493864,2021-10-13 18:07:33
8136,34,Uttar Pradesh,117477937,92121480,25356457,2021-10-13 18:07:33
8137,35,Uttarakhand,10823917,7424102,3399815,2021-10-13 18:07:33
8138,36,West Bengal,65516836,47392984,18123852,2021-10-13 18:07:33
8139,37,Daman and Diu,438373,268990,169383,2021-10-13 18:07:33
8140,1,Andaman and Nicobar Islands,464438,292202,172236,2021-10-14 18:21:06
8141,2,Andhra Pradesh,46330886,29886826,16444060,2021-10-14 18:21:06
8142,3,Arunachal Pradesh,1246468,764951,481517,2021-10-14 18:21:06
8143,4,Assam,26207922,19696843,6511079,2021-10-14 18:21:06
8144,5,Bihar,61392171,47225657,14166514,2021-10-14 18:21:06
8145,6,Chandigarh,1415601,917117,498484,2021-10-14 18:21:06
8146,7,Chhattisgarh,19427494,13264036,6163458,2021-10-14 18:21:06
8147,8,Dadra and Nagar Haveli,545812,384962,160850,2021-10-14 18:21:06
8148,9,Delhi,19441376,12688483,6752893,2021-10-14 18:21:06
8149,10,Goa,2052417,1245262,807155,2021-10-14 18:21:06
8150,11,Gujarat,66352359,43871020,22481339,2021-10-14 18:21:06
8151,12,Haryana,24557839,17354348,7203491,2021-10-14 18:21:06
8152,13,Himachal Pradesh,8692121,5686444,3005677,2021-10-14 18:21:06
8153,14,Jammu and Kashmir,13522607,9336897,4185710,2021-10-14 18:21:06
8154,15,Jharkhand,19045672,14357944,4687728,2021-10-14 18:21:06
8155,16,Karnataka,60545989,40698945,19847044,2021-10-14 18:21:06
8156,17,Kerala,37018227,25038799,11979428,2021-10-14 18:21:06
8157,18,Ladakh,353979,207495,146484,2021-10-14 18:21:06
8158,19,Lakshadweep,99430,55027,44403,2021-10-14 18:21:06
8159,20,Madhya Pradesh,65937977,49096415,16841562,2021-10-14 18:21:06
8160,21,Maharashtra,90737443,62891311,27846132,2021-10-14 18:21:06
8161,22,Manipur,1809596,1234670,574926,2021-10-14 18:21:06
8162,23,Meghalaya,1634272,1086428,547844,2021-10-14 18:21:06
8163,24,Mizoram,1191235,704239,486996,2021-10-14 18:21:06
8164,25,Nagaland,1130804,699093,431711,2021-10-14 18:21:06
8165,26,Odisha,33786288,23983798,9802490,2021-10-14 18:21:06
8166,27,Puducherry,1074615,717522,357093,2021-10-14 18:21:06
8167,28,Punjab,21069239,15383157,5686082,2021-10-14 18:21:06
8168,29,Rajasthan,59743942,41728400,18015542,2021-10-14 18:21:06
8169,30,Sikkim,941440,520259,421181,2021-10-14 18:21:06
8170,31,Tamil Nadu,52584425,38788378,13796047,2021-10-14 18:21:06
8171,32,Telangana,28474048,20508344,7965704,2021-10-14 18:21:06
8172,33,Tripura,3995114,2501052,1494062,2021-10-14 18:21:06
8173,34,Uttar Pradesh,117717509,92236336,25481173,2021-10-14 18:21:06
8174,35,Uttarakhand,10857285,7428027,3429258,2021-10-14 18:21:06
8175,36,West Bengal,65571178,47436925,18134253,2021-10-14 18:21:06
8176,37,Daman and Diu,439464,269129,170335,2021-10-14 18:21:06
8177,1,Andaman and Nicobar Islands,464573,292209,172364,2021-10-15 18:07:31
8178,2,Andhra Pradesh,46372227,29905983,16466244,2021-10-15 18:07:31
8179,3,Arunachal Pradesh,1247467,764997,482470,2021-10-15 18:07:31
8180,4,Assam,26213261,19698755,6514506,2021-10-15 18:07:31
8181,5,Bihar,61447053,47246690,14200363,2021-10-15 18:07:31
8182,6,Chandigarh,1416424,917295,499129,2021-10-15 18:07:31
8183,7,Chhattisgarh,19436363,13267463,6168900,2021-10-15 18:07:31
8184,8,Dadra and Nagar Haveli,546602,385046,161556,2021-10-15 18:07:31
8185,9,Delhi,19443875,12688983,6754892,2021-10-15 18:07:31
8186,10,Goa,2055539,1245726,809813,2021-10-15 18:07:31
8187,11,Gujarat,66425058,43893930,22531128,2021-10-15 18:07:31
8188,12,Haryana,24581954,17361121,7220833,2021-10-15 18:07:31
8189,13,Himachal Pradesh,8699256,5686917,3012339,2021-10-15 18:07:31
8190,14,Jammu and Kashmir,13592265,9364750,4227515,2021-10-15 18:07:31
8191,15,Jharkhand,19052443,14361660,4690783,2021-10-15 18:07:31
8192,16,Karnataka,60596975,40716201,19880774,2021-10-15 18:07:31
8193,17,Kerala,37061666,25047212,12014454,2021-10-15 18:07:31
8194,18,Ladakh,354019,207495,146524,2021-10-15 18:07:31
8195,19,Lakshadweep,99533,55027,44506,2021-10-15 18:07:31
8196,20,Madhya Pradesh,65947620,49097720,16849900,2021-10-15 18:07:31
8197,21,Maharashtra,90787075,62922337,27864738,2021-10-15 18:07:31
8198,22,Manipur,1815484,1235197,580287,2021-10-15 18:07:31
8199,23,Meghalaya,1640309,1087409,552900,2021-10-15 18:07:31
8200,24,Mizoram,1192964,704598,488366,2021-10-15 18:07:31
8201,25,Nagaland,1132322,699381,432941,2021-10-15 18:07:31
8202,26,Odisha,33910410,24067363,9843047,2021-10-15 18:07:31
8203,27,Puducherry,1077969,718358,359611,2021-10-15 18:07:31
8204,28,Punjab,21081062,15390356,5690706,2021-10-15 18:07:31
8205,29,Rajasthan,59915358,41786195,18129163,2021-10-15 18:07:31
8206,30,Sikkim,941564,520263,421301,2021-10-15 18:07:31
8207,31,Tamil Nadu,52661301,38820442,13840859,2021-10-15 18:07:31
8208,32,Telangana,28477489,20510497,7966992,2021-10-15 18:07:31
8209,33,Tripura,3995125,2501053,1494072,2021-10-15 18:07:31
8210,34,Uttar Pradesh,117803909,92269085,25534824,2021-10-15 18:07:31
8211,35,Uttarakhand,10864923,7428681,3436242,2021-10-15 18:07:31
8212,36,West Bengal,65614914,47473079,18141835,2021-10-15 18:07:31
8213,37,Daman and Diu,439871,269193,170678,2021-10-15 18:07:31
8214,1,Andaman and Nicobar Islands,467115,292321,174794,2021-10-16 18:21:37
8215,2,Andhra Pradesh,46658088,30022613,16635475,2021-10-16 18:21:37
8216,3,Arunachal Pradesh,1250360,765306,485054,2021-10-16 18:21:37
8217,4,Assam,26270804,19712860,6557944,2021-10-16 18:21:37
8218,5,Bihar,61546629,47277088,14269541,2021-10-16 18:21:37
8219,6,Chandigarh,1421990,918209,503781,2021-10-16 18:21:37
8220,7,Chhattisgarh,19522291,13299253,6223038,2021-10-16 18:21:37
8221,8,Dadra and Nagar Haveli,548923,385400,163523,2021-10-16 18:21:37
8222,9,Delhi,19556308,12725811,6830497,2021-10-16 18:21:37
8223,10,Goa,2064315,1246925,817390,2021-10-16 18:21:37
8224,11,Gujarat,66735261,43959144,22776117,2021-10-16 18:21:37
8225,12,Haryana,24664428,17392758,7271670,2021-10-16 18:21:37
8226,13,Himachal Pradesh,8732545,5689038,3043507,2021-10-16 18:21:37
8227,14,Jammu and Kashmir,13678358,9389365,4288993,2021-10-16 18:21:37
8228,15,Jharkhand,19097507,14379948,4717559,2021-10-16 18:21:37
8229,16,Karnataka,60849564,40790607,20058957,2021-10-16 18:21:37
8230,17,Kerala,37237667,25077129,12160538,2021-10-16 18:21:37
8231,18,Ladakh,354695,207615,147080,2021-10-16 18:21:37
8232,19,Lakshadweep,99758,55037,44721,2021-10-16 18:21:37
8233,20,Madhya Pradesh,66072382,49111638,16960744,2021-10-16 18:21:37
8234,21,Maharashtra,91303493,63192324,28111169,2021-10-16 18:21:37
8235,22,Manipur,1827583,1236156,591427,2021-10-16 18:21:37
8236,23,Meghalaya,1644646,1088073,556573,2021-10-16 18:21:37
8237,24,Mizoram,1194127,704939,489188,2021-10-16 18:21:37
8238,25,Nagaland,1135207,699773,435434,2021-10-16 18:21:37
8239,26,Odisha,34077407,24160887,9916520,2021-10-16 18:21:37
8240,27,Puducherry,1083361,719520,363841,2021-10-16 18:21:37
8241,28,Punjab,21188998,15446692,5742306,2021-10-16 18:21:37
8242,29,Rajasthan,60286363,41904526,18381837,2021-10-16 18:21:37
8243,30,Sikkim,941782,520272,421510,2021-10-16 18:21:37
8244,31,Tamil Nadu,52869426,38900975,13968451,2021-10-16 18:21:37
8245,32,Telangana,28487078,20514692,7972386,2021-10-16 18:21:37
8246,33,Tripura,3998631,2501319,1497312,2021-10-16 18:21:37
8247,34,Uttar Pradesh,118190370,92364888,25825482,2021-10-16 18:21:37
8248,35,Uttarakhand,10892919,7432013,3460906,2021-10-16 18:21:37
8249,36,West Bengal,66218386,47969148,18249238,2021-10-16 18:21:37
8250,37,Daman and Diu,441303,269400,171903,2021-10-16 18:21:37
8251,1,Andaman and Nicobar Islands,467128,292322,174806,2021-10-17 18:19:27
8252,2,Andhra Pradesh,46697061,30038669,16658392,2021-10-17 18:19:27
8253,3,Arunachal Pradesh,1250986,765361,485625,2021-10-17 18:19:27
8254,4,Assam,26308490,19723346,6585144,2021-10-17 18:19:27
8255,5,Bihar,61604390,47293746,14310644,2021-10-17 18:19:27
8256,6,Chandigarh,1424417,918635,505782,2021-10-17 18:19:27
8257,7,Chhattisgarh,19574677,13318537,6256140,2021-10-17 18:19:27
8258,8,Dadra and Nagar Haveli,549365,385461,163904,2021-10-17 18:19:27
8259,9,Delhi,19600222,12740721,6859501,2021-10-17 18:19:27
8260,10,Goa,2069753,1247562,822191,2021-10-17 18:19:27
8261,11,Gujarat,66835253,43983516,22851737,2021-10-17 18:19:27
8262,12,Haryana,24710068,17403476,7306592,2021-10-17 18:19:27
8263,13,Himachal Pradesh,8737307,5689408,3047899,2021-10-17 18:19:27
8264,14,Jammu and Kashmir,13738993,9404262,4334731,2021-10-17 18:19:27
8265,15,Jharkhand,19159308,14406331,4752977,2021-10-17 18:19:27
8266,16,Karnataka,60894744,40810010,20084734,2021-10-17 18:19:27
8267,17,Kerala,37250734,25079316,12171418,2021-10-17 18:19:27
8268,18,Ladakh,354698,207615,147083,2021-10-17 18:19:27
8269,19,Lakshadweep,99764,55038,44726,2021-10-17 18:19:27
8270,20,Madhya Pradesh,66093135,49114255,16978880,2021-10-17 18:19:27
8271,21,Maharashtra,91433847,63269515,28164332,2021-10-17 18:19:27
8272,22,Manipur,1829022,1236392,592630,2021-10-17 18:19:27
8273,23,Meghalaya,1644709,1088084,556625,2021-10-17 18:19:27
8274,24,Mizoram,1194247,705057,489190,2021-10-17 18:19:27
8275,25,Nagaland,1137378,699980,437398,2021-10-17 18:19:27
8276,26,Odisha,34107744,24178341,9929403,2021-10-17 18:19:27
8277,27,Puducherry,1084780,719868,364912,2021-10-17 18:19:27
8278,28,Punjab,21213217,15459433,5753784,2021-10-17 18:19:27
8279,29,Rajasthan,60386423,41940064,18446359,2021-10-17 18:19:27
8280,30,Sikkim,942001,520283,421718,2021-10-17 18:19:27
8281,31,Tamil Nadu,52990161,38948963,14041198,2021-10-17 18:19:27
8282,32,Telangana,28491556,20517000,7974556,2021-10-17 18:19:27
8283,33,Tripura,3998774,2501325,1497449,2021-10-17 18:19:27
8284,34,Uttar Pradesh,118232348,92384187,25848161,2021-10-17 18:19:27
8285,35,Uttarakhand,10906229,7433295,3472934,2021-10-17 18:19:27
8286,36,West Bengal,66525880,48240134,18285746,2021-10-17 18:19:27
8287,37,Daman and Diu,441303,269400,171903,2021-10-17 18:19:27
8288,1,Andaman and Nicobar Islands,470071,292528,177543,2021-10-18 18:18:24
8289,2,Andhra Pradesh,47447969,30307722,17140247,2021-10-18 18:18:24
8290,3,Arunachal Pradesh,1257067,765975,491092,2021-10-18 18:18:24
8291,4,Assam,26414247,19751414,6662833,2021-10-18 18:18:24
8292,5,Bihar,62683062,47656678,15026384,2021-10-18 18:18:24
8293,6,Chandigarh,1428824,919359,509465,2021-10-18 18:18:24
8294,7,Chhattisgarh,19736635,13385772,6350863,2021-10-18 18:18:24
8295,8,Dadra and Nagar Haveli,552342,385752,166590,2021-10-18 18:18:24
8296,9,Delhi,19695972,12773219,6922753,2021-10-18 18:18:24
8297,10,Goa,2078348,1248774,829574,2021-10-18 18:18:24
8298,11,Gujarat,67216465,44062469,23153996,2021-10-18 18:18:24
8299,12,Haryana,24814466,17441340,7373126,2021-10-18 18:18:24
8300,13,Himachal Pradesh,8771393,5691395,3079998,2021-10-18 18:18:24
8301,14,Jammu and Kashmir,13825639,9422490,4403149,2021-10-18 18:18:24
8302,15,Jharkhand,19253327,14446713,4806614,2021-10-18 18:18:24
8303,16,Karnataka,61190667,40897611,20293056,2021-10-18 18:18:24
8304,17,Kerala,37421472,25106726,12314746,2021-10-18 18:18:24
8305,18,Ladakh,355511,207866,147645,2021-10-18 18:18:24
8306,19,Lakshadweep,99863,55040,44823,2021-10-18 18:18:24
8307,20,Madhya Pradesh,66664352,49164383,17499969,2021-10-18 18:18:24
8308,21,Maharashtra,92064542,63619142,28445400,2021-10-18 18:18:24
8309,22,Manipur,1842007,1237548,604459,2021-10-18 18:18:24
8310,23,Meghalaya,1654133,1089363,564770,2021-10-18 18:18:24
8311,24,Mizoram,1197079,705644,491435,2021-10-18 18:18:24
8312,25,Nagaland,1146038,701187,444851,2021-10-18 18:18:24
8313,26,Odisha,34391944,24341650,10050294,2021-10-18 18:18:24
8314,27,Puducherry,1090564,721220,369344,2021-10-18 18:18:24
8315,28,Punjab,21312789,15512316,5800473,2021-10-18 18:18:24
8316,29,Rajasthan,60654421,42024892,18629529,2021-10-18 18:18:24
8317,30,Sikkim,943535,520368,423167,2021-10-18 18:18:24
8318,31,Tamil Nadu,53311487,39064884,14246603,2021-10-18 18:18:24
8319,32,Telangana,28787873,20682620,8105253,2021-10-18 18:18:24
8320,33,Tripura,4007992,2501957,1506035,2021-10-18 18:18:24
8321,34,Uttar Pradesh,120052418,93224321,26828097,2021-10-18 18:18:24
8322,35,Uttarakhand,10928189,7435802,3492387,2021-10-18 18:18:24
8323,36,West Bengal,67569795,49066121,18503674,2021-10-18 18:18:24
8324,37,Daman and Diu,443029,269726,173303,2021-10-18 18:18:24
8325,1,Andaman and Nicobar Islands,472626,292665,179961,2021-10-19 18:28:02
8326,2,Andhra Pradesh,47728296,30425411,17302885,2021-10-19 18:28:02
8327,3,Arunachal Pradesh,1260846,766403,494443,2021-10-19 18:28:02
8328,4,Assam,26546722,19777667,6769055,2021-10-19 18:28:02
8329,5,Bihar,63049284,47790300,15258984,2021-10-19 18:28:02
8330,6,Chandigarh,1433021,920073,512948,2021-10-19 18:28:02
8331,7,Chhattisgarh,19815627,13412888,6402739,2021-10-19 18:28:02
8332,8,Dadra and Nagar Haveli,554671,385937,168734,2021-10-19 18:28:02
8333,9,Delhi,19770761,12797955,6972806,2021-10-19 18:28:02
8334,10,Goa,2084722,1249646,835076,2021-10-19 18:28:02
8335,11,Gujarat,67360590,44099049,23261541,2021-10-19 18:28:02
8336,12,Haryana,24912073,17478532,7433541,2021-10-19 18:28:02
8337,13,Himachal Pradesh,8803650,5693526,3110124,2021-10-19 18:28:02
8338,14,Jammu and Kashmir,13899915,9438180,4461735,2021-10-19 18:28:02
8339,15,Jharkhand,19360508,14490217,4870291,2021-10-19 18:28:02
8340,16,Karnataka,61346451,40955212,20391239,2021-10-19 18:28:02
8341,17,Kerala,37480053,25115770,12364283,2021-10-19 18:28:02
8342,18,Ladakh,355534,207873,147661,2021-10-19 18:28:02
8343,19,Lakshadweep,99868,55040,44828,2021-10-19 18:28:02
8344,20,Madhya Pradesh,66791851,49178855,17612996,2021-10-19 18:28:02
8345,21,Maharashtra,92333755,63751667,28582088,2021-10-19 18:28:02
8346,22,Manipur,1848866,1238121,610745,2021-10-19 18:28:02
8347,23,Meghalaya,1662880,1090713,572167,2021-10-19 18:28:02
8348,24,Mizoram,1197568,705793,491775,2021-10-19 18:28:02
8349,25,Nagaland,1150348,701850,448498,2021-10-19 18:28:02
8350,26,Odisha,34666216,24501143,10165073,2021-10-19 18:28:02
8351,27,Puducherry,1092883,721696,371187,2021-10-19 18:28:02
8352,28,Punjab,21435127,15580075,5855052,2021-10-19 18:28:02
8353,29,Rajasthan,60780742,42063587,18717155,2021-10-19 18:28:02
8354,30,Sikkim,945722,520441,425281,2021-10-19 18:28:02
8355,31,Tamil Nadu,53496078,39127480,14368598,2021-10-19 18:28:02
8356,32,Telangana,29058694,20834756,8223938,2021-10-19 18:28:02
8357,33,Tripura,4009661,2502028,1507633,2021-10-19 18:28:02
8358,34,Uttar Pradesh,120882129,93594568,27287561,2021-10-19 18:28:02
8359,35,Uttarakhand,10949456,7438351,3511105,2021-10-19 18:28:02
8360,36,West Bengal,68233435,49570882,18662553,2021-10-19 18:28:02
8361,37,Daman and Diu,443114,269730,173384,2021-10-19 18:28:02
8362,1,Andaman and Nicobar Islands,472762,292669,180093,2021-10-20 23:30
8363,2,Andhra Pradesh,48125215,30590290,17534925,2021-10-20 23:30
8364,3,Arunachal Pradesh,1264939,766828,498111,2021-10-20 23:30
8365,4,Assam,26605855,19791055,6814800,2021-10-20 23:30
8366,5,Bihar,63340552,47901265,15439287,2021-10-20 23:30
8367,6,Chandigarh,1435606,920455,515151,2021-10-20 23:30
8368,7,Chhattisgarh,19950355,13465235,6485120,2021-10-20 23:30
8369,8,Dadra and Nagar Haveli,556543,386159,170384,2021-10-20 23:30
8370,9,Delhi,19834020,12819658,7014362,2021-10-20 23:30
8371,10,Goa,2091144,1250494,840650,2021-10-20 23:30
8372,11,Gujarat,67664968,44163934,23501034,2021-10-20 23:30
8373,12,Haryana,24972730,17495165,7477565,2021-10-20 23:30
8374,13,Himachal Pradesh,8815097,5694279,3120818,2021-10-20 23:30
8375,14,Jammu and Kashmir,13974372,9450055,4524317,2021-10-20 23:30
8376,15,Jharkhand,19467337,14535258,4932079,2021-10-20 23:30
8377,16,Karnataka,61558336,41031154,20527182,2021-10-20 23:30
8378,17,Kerala,37567873,25130834,12437039,2021-10-20 23:30
8379,18,Ladakh,356153,208021,148132,2021-10-20 23:30
8380,19,Lakshadweep,99935,55048,44887,2021-10-20 23:30
8381,20,Madhya Pradesh,66921012,49195807,17725205,2021-10-20 23:30
8382,21,Maharashtra,92833968,64028071,28805897,2021-10-20 23:30
8383,22,Manipur,1854761,1238699,616062,2021-10-20 23:30
8384,23,Meghalaya,1670135,1091782,578353,2021-10-20 23:30
8385,24,Mizoram,1200767,706070,494697,2021-10-20 23:30
8386,25,Nagaland,1157353,702867,454486,2021-10-20 23:30
8387,26,Odisha,34861203,24611717,10249486,2021-10-20 23:30
8388,27,Puducherry,1097424,722733,374691,2021-10-20 23:30
8389,28,Punjab,21458477,15593196,5865281,2021-10-20 23:30
8390,29,Rajasthan,60998973,42126073,18872900,2021-10-20 23:30
8391,30,Sikkim,949181,520553,428628,2021-10-20 23:30
8392,31,Tamil Nadu,53652707,39178055,14474652,2021-10-20 23:30
8393,32,Telangana,29265371,20950881,8314490,2021-10-20 23:30
8394,33,Tripura,4010003,2502032,1507971,2021-10-20 23:30
8395,34,Uttar Pradesh,121935770,94104896,27830874,2021-10-20 23:30
8396,35,Uttarakhand,10971082,7440710,3530372,2021-10-20 23:30
8397,36,West Bengal,68509305,49771179,18738126,2021-10-20 23:30
8398,37,Daman and Diu,445002,270040,174962,2021-10-20 23:30
8399,1,Andaman and Nicobar Islands,476543,292801,183742,2021-10-21 23:30
8400,2,Andhra Pradesh,49022199,31254552,17767647,2021-10-21 23:30
8401,3,Arunachal Pradesh,1269962,767356,502606,2021-10-21 23:30
8402,4,Assam,26758673,19819710,6938963,2021-10-21 23:30
8403,5,Bihar,63910628,48235219,15675409,2021-10-21 23:30
8404,6,Chandigarh,1439448,921058,518390,2021-10-21 23:30
8405,7,Chhattisgarh,20952100,14373828,6578272,2021-10-21 23:30
8406,8,Dadra and Nagar Haveli,558994,386389,172605,2021-10-21 23:30
8407,9,Delhi,19908804,12845186,7063618,2021-10-21 23:30
8408,10,Goa,2096989,1251297,845692,2021-10-21 23:30
8409,11,Gujarat,68018522,44235624,23782898,2021-10-21 23:30
8410,12,Haryana,25134390,17542792,7591598,2021-10-21 23:30
8411,13,Himachal Pradesh,8846589,5696403,3150186,2021-10-21 23:30
8412,14,Jammu and Kashmir,14053865,9461882,4591983,2021-10-21 23:30
8413,15,Jharkhand,19558952,14573535,4985417,2021-10-21 23:30
8414,16,Karnataka,62166999,41518025,20648974,2021-10-21 23:30
8415,17,Kerala,37717817,25153284,12564533,2021-10-21 23:30
8416,18,Ladakh,356552,208116,148436,2021-10-21 23:30
8417,19,Lakshadweep,99975,55048,44927,2021-10-21 23:30
8418,20,Madhya Pradesh,67833069,49696705,18136364,2021-10-21 23:30
8419,21,Maharashtra,93993470,64924238,29069232,2021-10-21 23:30
8420,22,Manipur,1864124,1239478,624646,2021-10-21 23:30
8421,23,Meghalaya,1679225,1093154,586071,2021-10-21 23:30
8422,24,Mizoram,1203890,706621,497269,2021-10-21 23:30
8423,25,Nagaland,1162573,703555,459018,2021-10-21 23:30
8424,26,Odisha,35120054,24750789,10369265,2021-10-21 23:30
8425,27,Puducherry,1101134,723581,377553,2021-10-21 23:30
8426,28,Punjab,21575791,15651589,5924202,2021-10-21 23:30
8427,29,Rajasthan,61157432,42173202,18984230,2021-10-21 23:30
8428,30,Sikkim,953048,520703,432345,2021-10-21 23:30
8429,31,Tamil Nadu,54340228,39729302,14610926,2021-10-21 23:30
8430,32,Telangana,29573687,21106299,8467388,2021-10-21 23:30
8431,33,Tripura,4021507,2502779,1518728,2021-10-21 23:30
8432,34,Uttar Pradesh,123239136,94857154,28381982,2021-10-21 23:30
8433,35,Uttarakhand,11007104,7444668,3562436,2021-10-21 23:30
8434,36,West Bengal,69434307,50440073,18994234,2021-10-21 23:30
8435,37,Daman and Diu,446513,270341,176172,2021-10-21 23:30
8436,1,Andaman and Nicobar Islands,479558,292983,186575,2021-10-22 23:30
8437,2,Andhra Pradesh,49475603,31444024,18031579,2021-10-22 23:30
8438,3,Arunachal Pradesh,1275290,768011,507279,2021-10-22 23:30
8439,4,Assam,26925994,19853406,7072588,2021-10-22 23:30
8440,5,Bihar,64303390,48392319,15911071,2021-10-22 23:30
8441,6,Chandigarh,1443226,921706,521520,2021-10-22 23:30
8442,7,Chhattisgarh,21061083,14415192,6645891,2021-10-22 23:30
8443,8,Dadra and Nagar Haveli,561346,386617,174729,2021-10-22 23:30
8444,9,Delhi,19972801,12867945,7104856,2021-10-22 23:30
8445,10,Goa,2103909,1252224,851685,2021-10-22 23:30
8446,11,Gujarat,68339774,44307684,24032090,2021-10-22 23:30
8447,12,Haryana,25257959,17580937,7677022,2021-10-22 23:30
8448,13,Himachal Pradesh,8878504,5698536,3179968,2021-10-22 23:30
8449,14,Jammu and Kashmir,14117862,9469004,4648858,2021-10-22 23:30
8450,15,Jharkhand,19664000,14616261,5047739,2021-10-22 23:30
8451,16,Karnataka,63018218,41770998,21247220,2021-10-22 23:30
8452,17,Kerala,37885170,25175697,12709473,2021-10-22 23:30
8453,18,Ladakh,357727,208209,149518,2021-10-22 23:30
8454,19,Lakshadweep,100086,55049,45037,2021-10-22 23:30
8455,20,Madhya Pradesh,68103082,49722653,18380429,2021-10-22 23:30
8456,21,Maharashtra,94579527,65229794,29349733,2021-10-22 23:30
8457,22,Manipur,1876229,1240398,635831,2021-10-22 23:30
8458,23,Meghalaya,1688722,1094536,594186,2021-10-22 23:30
8459,24,Mizoram,1207679,707172,500507,2021-10-22 23:30
8460,25,Nagaland,1168906,704359,464547,2021-10-22 23:30
8461,26,Odisha,35371499,24879133,10492366,2021-10-22 23:30
8462,27,Puducherry,1104589,724363,380226,2021-10-22 23:30
8463,28,Punjab,21649753,15688010,5961743,2021-10-22 23:30
8464,29,Rajasthan,61346963,42228390,19118573,2021-10-22 23:30
8465,30,Sikkim,957382,520901,436481,2021-10-22 23:30
8466,31,Tamil Nadu,54504803,39778666,14726137,2021-10-22 23:30
8467,32,Telangana,29886288,21261627,8624661,2021-10-22 23:30
8468,33,Tripura,4035494,2503544,1531950,2021-10-22 23:30
8469,34,Uttar Pradesh,124442567,95438144,29004423,2021-10-22 23:30
8470,35,Uttarakhand,11047783,7448839,3598944,2021-10-22 23:30
8471,36,West Bengal,70558197,51242754,19315443,2021-10-22 23:30
8472,37,Daman and Diu,447998,270581,177417,2021-10-22 23:30
8473,1,Andaman and Nicobar Islands,482327,293105,189222,2021-10-23 23:30
8474,2,Andhra Pradesh,49908418,31624055,18284363,2021-10-23 23:30
8475,3,Arunachal Pradesh,1278781,768471,510310,2021-10-23 23:30
8476,4,Assam,27070228,19884056,7186172,2021-10-23 23:30
8477,5,Bihar,64651001,48528798,16122203,2021-10-23 23:30
8478,6,Chandigarh,1447141,922279,524862,2021-10-23 23:30
8479,7,Chhattisgarh,21175157,14460034,6715123,2021-10-23 23:30
8480,8,Dadra and Nagar Haveli,563484,386865,176619,2021-10-23 23:30
8481,9,Delhi,20046785,12893328,7153457,2021-10-23 23:30
8482,10,Goa,2113349,1253513,859836,2021-10-23 23:30
8483,11,Gujarat,68637483,44380521,24256962,2021-10-23 23:30
8484,12,Haryana,25348401,17608448,7739953,2021-10-23 23:30
8485,13,Himachal Pradesh,8908931,5700386,3208545,2021-10-23 23:30
8486,14,Jammu and Kashmir,14173705,9474036,4699669,2021-10-23 23:30
8487,15,Jharkhand,19756569,14655014,5101555,2021-10-23 23:30
8488,16,Karnataka,63298274,41851072,21447202,2021-10-23 23:30
8489,17,Kerala,38044840,25194776,12850064,2021-10-23 23:30
8490,18,Ladakh,359019,208273,150746,2021-10-23 23:30
8491,19,Lakshadweep,100205,55060,45145,2021-10-23 23:30
8492,20,Madhya Pradesh,68535339,49760721,18774618,2021-10-23 23:30
8493,21,Maharashtra,95159631,65516051,29643580,2021-10-23 23:30
8494,22,Manipur,1887214,1241394,645820,2021-10-23 23:30
8495,23,Meghalaya,1695110,1095352,599758,2021-10-23 23:30
8496,24,Mizoram,1207992,707294,500698,2021-10-23 23:30
8497,25,Nagaland,1170650,704662,465988,2021-10-23 23:30
8498,26,Odisha,35607645,24984960,10622685,2021-10-23 23:30
8499,27,Puducherry,1108778,725321,383457,2021-10-23 23:30
8500,28,Punjab,21747862,15736888,6010974,2021-10-23 23:30
8501,29,Rajasthan,61487137,42267872,19219265,2021-10-23 23:30
8502,30,Sikkim,958445,520981,437464,2021-10-23 23:30
8503,31,Tamil Nadu,56271247,40382172,15889075,2021-10-23 23:30
8504,32,Telangana,30189057,21403874,8785183,2021-10-23 23:30
8505,33,Tripura,4048754,2504205,1544549,2021-10-23 23:30
8506,34,Uttar Pradesh,125403004,95876953,29526051,2021-10-23 23:30
8507,35,Uttarakhand,11083530,7452083,3631447,2021-10-23 23:30
8508,36,West Bengal,71799420,52169716,19629704,2021-10-23 23:30
8509,37,Daman and Diu,450266,271049,179217,2021-10-23 23:30
8510,1,Andaman and Nicobar Islands,482612,293117,189495,2021-10-24 23:30
8511,2,Andhra Pradesh,50241318,31753568,18487750,2021-10-24 23:30
8512,3,Arunachal Pradesh,1279402,768563,510839,2021-10-24 23:30
8513,4,Assam,27116081,19897435,7218646,2021-10-24 23:30
8514,5,Bihar,64789008,48587525,16201483,2021-10-24 23:30
8515,6,Chandigarh,1447695,922355,525340,2021-10-24 23:30
8516,7,Chhattisgarh,21211226,14472264,6738962,2021-10-24 23:30
8517,8,Dadra and Nagar Haveli,563696,386902,176794,2021-10-24 23:30
8518,9,Delhi,20051571,12895313,7156258,2021-10-24 23:30
8519,10,Goa,2118770,1254150,864620,2021-10-24 23:30
8520,11,Gujarat,68711937,44400001,24311936,2021-10-24 23:30
8521,12,Haryana,25358798,17611526,7747272,2021-10-24 23:30
8522,13,Himachal Pradesh,8910257,5700450,3209807,2021-10-24 23:30
8523,14,Jammu and Kashmir,14211788,9477494,4734294,2021-10-24 23:30
8524,15,Jharkhand,19843177,14686485,5156692,2021-10-24 23:30
8525,16,Karnataka,63358284,41874008,21484276,2021-10-24 23:30
8526,17,Kerala,38062496,25196691,12865805,2021-10-24 23:30
8527,18,Ladakh,359020,208273,150747,2021-10-24 23:30
8528,19,Lakshadweep,100215,55060,45155,2021-10-24 23:30
8529,20,Madhya Pradesh,68566201,49763076,18803125,2021-10-24 23:30
8530,21,Maharashtra,95277821,65585574,29692247,2021-10-24 23:30
8531,22,Manipur,1889892,1241756,648136,2021-10-24 23:30
8532,23,Meghalaya,1695285,1095404,599881,2021-10-24 23:30
8533,24,Mizoram,1208062,707295,500767,2021-10-24 23:30
8534,25,Nagaland,1171776,704837,466939,2021-10-24 23:30
8535,26,Odisha,35647854,25004436,10643418,2021-10-24 23:30
8536,27,Puducherry,1109952,725635,384317,2021-10-24 23:30
8537,28,Punjab,21758153,15742469,6015684,2021-10-24 23:30
8538,29,Rajasthan,61505880,42273285,19232595,2021-10-24 23:30
8539,30,Sikkim,958446,520981,437465,2021-10-24 23:30
8540,31,Tamil Nadu,56530247,40489703,16040544,2021-10-24 23:30
8541,32,Telangana,30236605,21425719,8810886,2021-10-24 23:30
8542,33,Tripura,4051009,2504322,1546687,2021-10-24 23:30
8543,34,Uttar Pradesh,125461912,95911393,29550519,2021-10-24 23:30
8544,35,Uttarakhand,11092724,7452767,3639957,2021-10-24 23:30
8545,36,West Bengal,72069803,52381909,19687894,2021-10-24 23:30
8546,37,Daman and Diu,450266,271049,179217,2021-10-24 23:30
8547,1,Andaman and Nicobar Islands,485105,293331,191774,2021-10-25 23:30
8548,2,Andhra Pradesh,50784249,31961286,18822963,2021-10-25 23:30
8549,3,Arunachal Pradesh,1284879,769196,515683,2021-10-25 23:30
8550,4,Assam,27304034,19935903,7368131,2021-10-25 23:30
8551,5,Bihar,65005746,48671521,16334225,2021-10-25 23:30
8552,6,Chandigarh,1451995,923020,528975,2021-10-25 23:30
8553,7,Chhattisgarh,21411809,14548425,6863384,2021-10-25 23:30
8554,8,Dadra and Nagar Haveli,565402,387101,178301,2021-10-25 23:30
8555,9,Delhi,20128524,12923060,7205464,2021-10-25 23:30
8556,10,Goa,2126640,1255244,871396,2021-10-25 23:30
8557,11,Gujarat,68999060,44456503,24542557,2021-10-25 23:30
8558,12,Haryana,25460188,17642386,7817802,2021-10-25 23:30
8559,13,Himachal Pradesh,8946916,5702335,3244581,2021-10-25 23:30
8560,14,Jammu and Kashmir,14276786,9483282,4793504,2021-10-25 23:30
8561,15,Jharkhand,19945500,14726230,5219270,2021-10-25 23:30
8562,16,Karnataka,63638053,41947599,21690454,2021-10-25 23:30
8563,17,Kerala,38223615,25215748,13007867,2021-10-25 23:30
8564,18,Ladakh,359512,208410,151102,2021-10-25 23:30
8565,19,Lakshadweep,100385,55068,45317,2021-10-25 23:30
8566,20,Madhya Pradesh,68954974,49789256,19165718,2021-10-25 23:30
8567,21,Maharashtra,95800892,65867137,29933755,2021-10-25 23:30
8568,22,Manipur,1905656,1243281,662375,2021-10-25 23:30
8569,23,Meghalaya,1703915,1096560,607355,2021-10-25 23:30
8570,24,Mizoram,1211846,708292,503554,2021-10-25 23:30
8571,25,Nagaland,1179072,706016,473056,2021-10-25 23:30
8572,26,Odisha,35921573,25137473,10784100,2021-10-25 23:30
8573,27,Puducherry,1120109,729142,390967,2021-10-25 23:30
8574,28,Punjab,21829791,15776937,6052854,2021-10-25 23:30
8575,29,Rajasthan,61650572,42309586,19340986,2021-10-25 23:30
8576,30,Sikkim,962678,521146,441532,2021-10-25 23:30
8577,31,Tamil Nadu,56716705,40558399,16158306,2021-10-25 23:30
8578,32,Telangana,30507039,21551837,8955202,2021-10-25 23:30
8579,33,Tripura,4070437,2505432,1565005,2021-10-25 23:30
8580,34,Uttar Pradesh,126718727,96500461,30218266,2021-10-25 23:30
8581,35,Uttarakhand,11137964,7457359,3680605,2021-10-25 23:30
8582,36,West Bengal,73086195,53041486,20044709,2021-10-25 23:30
8583,37,Daman and Diu,452681,271564,181117,2021-10-25 23:30
8584,1,Andaman and Nicobar Islands,487529,293503,194026,2021-10-26 23:30
8585,2,Andhra Pradesh,51339248,32197597,19141651,2021-10-26 23:30
8586,3,Arunachal Pradesh,1289665,769750,519915,2021-10-26 23:30
8587,4,Assam,27496569,19977243,7519326,2021-10-26 23:30
8588,5,Bihar,65176596,48738114,16438482,2021-10-26 23:30
8589,6,Chandigarh,1456217,923631,532586,2021-10-26 23:30
8590,7,Chhattisgarh,21543068,14596040,6947028,2021-10-26 23:30
8591,8,Dadra and Nagar Haveli,567385,387278,180107,2021-10-26 23:30
8592,9,Delhi,20202215,12949359,7252856,2021-10-26 23:30
8593,10,Goa,2134151,1256323,877828,2021-10-26 23:30
8594,11,Gujarat,69351155,44520171,24830984,2021-10-26 23:30
8595,12,Haryana,25562444,17674592,7887852,2021-10-26 23:30
8596,13,Himachal Pradesh,8988928,5704585,3284343,2021-10-26 23:30
8597,14,Jammu and Kashmir,14337716,9489181,4848535,2021-10-26 23:30
8598,15,Jharkhand,20063597,14772014,5291583,2021-10-26 23:30
8599,16,Karnataka,63869995,42013339,21856656,2021-10-26 23:30
8600,17,Kerala,38428240,25237242,13190998,2021-10-26 23:30
8601,18,Ladakh,359894,208526,151368,2021-10-26 23:30
8602,19,Lakshadweep,100496,55069,45427,2021-10-26 23:30
8603,20,Madhya Pradesh,69117650,49802635,19315015,2021-10-26 23:30
8604,21,Maharashtra,96280946,66132019,30148927,2021-10-26 23:30
8605,22,Manipur,1915978,1244261,671717,2021-10-26 23:30
8606,23,Meghalaya,1713069,1097818,615251,2021-10-26 23:30
8607,24,Mizoram,1214852,709232,505620,2021-10-26 23:30
8608,25,Nagaland,1184174,706835,477339,2021-10-26 23:30
8609,26,Odisha,36194763,25264236,10930527,2021-10-26 23:30
8610,27,Puducherry,1125916,730702,395214,2021-10-26 23:30
8611,28,Punjab,21932767,15826694,6106073,2021-10-26 23:30
8612,29,Rajasthan,61816350,42355630,19460720,2021-10-26 23:30
8613,30,Sikkim,965569,521288,444281,2021-10-26 23:30
8614,31,Tamil Nadu,56983254,40652636,16330618,2021-10-26 23:30
8615,32,Telangana,30791432,21687768,9103664,2021-10-26 23:30
8616,33,Tripura,4089243,2506405,1582838,2021-10-26 23:30
8617,34,Uttar Pradesh,127736916,96899855,30837061,2021-10-26 23:30
8618,35,Uttarakhand,11184401,7461705,3722696,2021-10-26 23:30
8619,36,West Bengal,74025822,53664679,20361143,2021-10-26 23:30
8620,37,Daman and Diu,454624,272007,182617,2021-10-26 23:30
8621,1,Andaman and Nicobar Islands,489309,293638,195671,2021-10-27 23:30
8622,2,Andhra Pradesh,51857883,32411373,19446510,2021-10-27 23:30
8623,3,Arunachal Pradesh,1294079,770265,523814,2021-10-27 23:30
8624,4,Assam,27626223,20010686,7615537,2021-10-27 23:30
8625,5,Bihar,65305440,48785382,16520058,2021-10-27 23:30
8626,6,Chandigarh,1460108,924247,535861,2021-10-27 23:30
8627,7,Chhattisgarh,21700680,14657085,7043595,2021-10-27 23:30
8628,8,Dadra and Nagar Haveli,568852,387455,181397,2021-10-27 23:30
8629,9,Delhi,20263470,12971655,7291815,2021-10-27 23:30
8630,10,Goa,2140064,1257226,882838,2021-10-27 23:30
8631,11,Gujarat,69594229,44565485,25028744,2021-10-27 23:30
8632,12,Haryana,25639129,17697673,7941456,2021-10-27 23:30
8633,13,Himachal Pradesh,9029165,5706786,3322379,2021-10-27 23:30
8634,14,Jammu and Kashmir,14403561,9494948,4908613,2021-10-27 23:30
8635,15,Jharkhand,20176012,14817744,5358268,2021-10-27 23:30
8636,16,Karnataka,64530719,42211611,22319108,2021-10-27 23:30
8637,17,Kerala,38492104,25245956,13246148,2021-10-27 23:30
8638,18,Ladakh,360190,208593,151597,2021-10-27 23:30
8639,19,Lakshadweep,100597,55076,45521,2021-10-27 23:30
8640,20,Madhya Pradesh,69474044,49826228,19647816,2021-10-27 23:30
8641,21,Maharashtra,96738759,66393691,30345068,2021-10-27 23:30
8642,22,Manipur,1927237,1245289,681948,2021-10-27 23:30
8643,23,Meghalaya,1721606,1099241,622365,2021-10-27 23:30
8644,24,Mizoram,1218263,710053,508210,2021-10-27 23:30
8645,25,Nagaland,1189465,707731,481734,2021-10-27 23:30
8646,26,Odisha,36453323,25380601,11072722,2021-10-27 23:30
8647,27,Puducherry,1129664,731792,397872,2021-10-27 23:30
8648,28,Punjab,21979132,15848678,6130454,2021-10-27 23:30
8649,29,Rajasthan,61892390,42374177,19518213,2021-10-27 23:30
8650,30,Sikkim,966147,521326,444821,2021-10-27 23:30
8651,31,Tamil Nadu,57147038,40708137,16438901,2021-10-27 23:30
8652,32,Telangana,31053859,21826056,9227803,2021-10-27 23:30
8653,33,Tripura,4097674,2506782,1590892,2021-10-27 23:30
8654,34,Uttar Pradesh,128343321,97150275,31193046,2021-10-27 23:30
8655,35,Uttarakhand,11227388,7465574,3761814,2021-10-27 23:30
8656,36,West Bengal,74571922,53983371,20588551,2021-10-27 23:30
8657,37,Daman and Diu,456191,272404,183787,2021-10-27 23:30
8658,1,Andaman and Nicobar Islands,491069,293776,197293,2021-10-28 23:30
8659,2,Andhra Pradesh,52410302,32640320,19769982,2021-10-28 23:30
8660,3,Arunachal Pradesh,1299160,770903,528257,2021-10-28 23:30
8661,4,Assam,27818525,20057009,7761516,2021-10-28 23:30
8662,5,Bihar,67288068,49500062,17788006,2021-10-28 23:30
8663,6,Chandigarh,1463372,924720,538652,2021-10-28 23:30
8664,7,Chhattisgarh,21861741,14721521,7140220,2021-10-28 23:30
8665,8,Dadra and Nagar Haveli,570269,387644,182625,2021-10-28 23:30
8666,9,Delhi,20318841,12992118,7326723,2021-10-28 23:30
8667,10,Goa,2145806,1258057,887749,2021-10-28 23:30
8668,11,Gujarat,69910326,44623330,25286996,2021-10-28 23:30
8669,12,Haryana,25703598,17716501,7987097,2021-10-28 23:30
8670,13,Himachal Pradesh,9068326,5708905,3359421,2021-10-28 23:30
8671,14,Jammu and Kashmir,14479734,9501004,4978730,2021-10-28 23:30
8672,15,Jharkhand,20271527,14855287,5416240,2021-10-28 23:30
8673,16,Karnataka,64783174,42301925,22481249,2021-10-28 23:30
8674,17,Kerala,38628244,25262906,13365338,2021-10-28 23:30
8675,18,Ladakh,360504,208676,151828,2021-10-28 23:30
8676,19,Lakshadweep,100739,55080,45659,2021-10-28 23:30
8677,20,Madhya Pradesh,69851548,49852883,19998665,2021-10-28 23:30
8678,21,Maharashtra,97203308,66654590,30548718,2021-10-28 23:30
8679,22,Manipur,1938079,1246400,691679,2021-10-28 23:30
8680,23,Meghalaya,1731112,1100763,630349,2021-10-28 23:30
8681,24,Mizoram,1220698,710665,510033,2021-10-28 23:30
8682,25,Nagaland,1192952,708314,484638,2021-10-28 23:30
8683,26,Odisha,36731169,25495722,11235447,2021-10-28 23:30
8684,27,Puducherry,1132542,732540,400002,2021-10-28 23:30
8685,28,Punjab,22054037,15885123,6168914,2021-10-28 23:30
8686,29,Rajasthan,62140745,42431929,19708816,2021-10-28 23:30
8687,30,Sikkim,969173,521508,447665,2021-10-28 23:30
8688,31,Tamil Nadu,57295945,40755853,16540092,2021-10-28 23:30
8689,32,Telangana,31428774,22025347,9403427,2021-10-28 23:30
8690,33,Tripura,4110071,2507468,1602603,2021-10-28 23:30
8691,34,Uttar Pradesh,129205409,97497563,31707846,2021-10-28 23:30
8692,35,Uttarakhand,11267280,7469116,3798164,2021-10-28 23:30
8693,36,West Bengal,75393539,54516153,20877386,2021-10-28 23:30
8694,37,Daman and Diu,457172,272604,184568,2021-10-28 23:30
8695,1,Andaman and Nicobar Islands,492624,293903,198721,2021-10-29 23:30
8696,2,Andhra Pradesh,52885442,32813511,20071931,2021-10-29 23:30
8697,3,Arunachal Pradesh,1303385,771430,531955,2021-10-29 23:30
8698,4,Assam,28008701,20106426,7902275,2021-10-29 23:30
8699,5,Bihar,67649621,49636932,18012689,2021-10-29 23:30
8700,6,Chandigarh,1467106,925241,541865,2021-10-29 23:30
8701,7,Chhattisgarh,22003001,14777217,7225784,2021-10-29 23:30
8702,8,Dadra and Nagar Haveli,571297,387766,183531,2021-10-29 23:30
8703,9,Delhi,20377618,13013578,7364040,2021-10-29 23:30
8704,10,Goa,2151144,1258902,892242,2021-10-29 23:30
8705,11,Gujarat,70264414,44673620,25590794,2021-10-29 23:30
8706,12,Haryana,25795579,17743383,8052196,2021-10-29 23:30
8707,13,Himachal Pradesh,9112670,5711374,3401296,2021-10-29 23:30
8708,14,Jammu and Kashmir,14543434,9505266,5038168,2021-10-29 23:30
8709,15,Jharkhand,20382364,14902725,5479639,2021-10-29 23:30
8710,16,Karnataka,65086725,42407311,22679414,2021-10-29 23:30
8711,17,Kerala,38780950,25281049,13499901,2021-10-29 23:30
8712,18,Ladakh,360757,208752,152005,2021-10-29 23:30
8713,19,Lakshadweep,100904,55086,45818,2021-10-29 23:30
8714,20,Madhya Pradesh,70076915,49868974,20207941,2021-10-29 23:30
8715,21,Maharashtra,97654341,66905802,30748539,2021-10-29 23:30
8716,22,Manipur,1950285,1247600,702685,2021-10-29 23:30
8717,23,Meghalaya,1739311,1102140,637171,2021-10-29 23:30
8718,24,Mizoram,1223132,711338,511794,2021-10-29 23:30
8719,25,Nagaland,1197699,709037,488662,2021-10-29 23:30
8720,26,Odisha,37002142,25612771,11389371,2021-10-29 23:30
8721,27,Puducherry,1134802,733131,401671,2021-10-29 23:30
8722,28,Punjab,22101058,15906819,6194239,2021-10-29 23:30
8723,29,Rajasthan,62389923,42489068,19900855,2021-10-29 23:30
8724,30,Sikkim,972415,521705,450710,2021-10-29 23:30
8725,31,Tamil Nadu,57426974,40795834,16631140,2021-10-29 23:30
8726,32,Telangana,31821824,22241529,9580295,2021-10-29 23:30
8727,33,Tripura,4121439,2508067,1613372,2021-10-29 23:30
8728,34,Uttar Pradesh,130120647,97884398,32236249,2021-10-29 23:30
8729,35,Uttarakhand,11317834,7473332,3844502,2021-10-29 23:30
8730,36,West Bengal,76415365,55220133,21195232,2021-10-29 23:30
8731,37,Daman and Diu,458813,272882,185931,2021-10-29 23:30
8732,1,Andaman and Nicobar Islands,494119,293998,200121,2021-10-30 23:30
8733,2,Andhra Pradesh,53305600,32955532,20350068,2021-10-30 23:30
8734,3,Arunachal Pradesh,1306124,771833,534291,2021-10-30 23:30
8735,4,Assam,28183485,20152542,8030943,2021-10-30 23:30
8736,5,Bihar,67945798,49753704,18192094,2021-10-30 23:30
8737,6,Chandigarh,1471523,925824,545699,2021-10-30 23:30
8738,7,Chhattisgarh,22130188,14828285,7301903,2021-10-30 23:30
8739,8,Dadra and Nagar Haveli,571304,387769,183535,2021-10-30 23:30
8740,9,Delhi,20456718,13043164,7413554,2021-10-30 23:30
8741,10,Goa,2158706,1259996,898710,2021-10-30 23:30
8742,11,Gujarat,70629081,44720370,25908711,2021-10-30 23:30
8743,12,Haryana,25862567,17763563,8099004,2021-10-30 23:30
8744,13,Himachal Pradesh,9148921,5713313,3435608,2021-10-30 23:30
8745,14,Jammu and Kashmir,14609072,9509148,5099924,2021-10-30 23:30
8746,15,Jharkhand,20475754,14943644,5532110,2021-10-30 23:30
8747,16,Karnataka,65308136,42479462,22828674,2021-10-30 23:30
8748,17,Kerala,38950728,25304454,13646274,2021-10-30 23:30
8749,18,Ladakh,361075,208798,152277,2021-10-30 23:30
8750,19,Lakshadweep,101075,55129,45946,2021-10-30 23:30
8751,20,Madhya Pradesh,70663461,49905905,20757556,2021-10-30 23:30
8752,21,Maharashtra,98084848,67142714,30942134,2021-10-30 23:30
8753,22,Manipur,1963861,1248731,715130,2021-10-30 23:30
8754,23,Meghalaya,1744852,1103237,641615,2021-10-30 23:30
8755,24,Mizoram,1223444,711466,511978,2021-10-30 23:30
8756,25,Nagaland,1199201,709361,489840,2021-10-30 23:30
8757,26,Odisha,37247296,25713913,11533383,2021-10-30 23:30
8758,27,Puducherry,1137645,733788,403857,2021-10-30 23:30
8759,28,Punjab,22172574,15938651,6233923,2021-10-30 23:30
8760,29,Rajasthan,62592818,42532384,20060434,2021-10-30 23:30
8761,30,Sikkim,973272,521763,451509,2021-10-30 23:30
8762,31,Tamil Nadu,58702514,41196911,17505603,2021-10-30 23:30
8763,32,Telangana,32202081,22457864,9744217,2021-10-30 23:30
8764,33,Tripura,4128887,2508466,1620421,2021-10-30 23:30
8765,34,Uttar Pradesh,130739994,98119438,32620556,2021-10-30 23:30
8766,35,Uttarakhand,11361855,7476932,3884923,2021-10-30 23:30
8767,36,West Bengal,77474740,55975588,21499152,2021-10-30 23:30
8768,37,Daman and Diu,459681,272981,186700,2021-10-30 23:30
8769,1,Andaman and Nicobar Islands,494158,294001,200157,2021-10-31 23:30
8770,2,Andhra Pradesh,53351495,32976723,20374772,2021-10-31 23:30
8771,3,Arunachal Pradesh,1306361,771875,534486,2021-10-31 23:30
8772,4,Assam,28240642,20172070,8068572,2021-10-31 23:30
8773,5,Bihar,68214939,49871471,18343468,2021-10-31 23:30
8774,6,Chandigarh,1473016,926035,546981,2021-10-31 23:30
8775,7,Chhattisgarh,22191967,14850127,7341840,2021-10-31 23:30
8776,8,Dadra and Nagar Haveli,571325,387772,183553,2021-10-31 23:30
8777,9,Delhi,20481006,13055627,7425379,2021-10-31 23:30
8778,10,Goa,2173640,1262558,911082,2021-10-31 23:30
8779,11,Gujarat,70706495,44735126,25971369,2021-10-31 23:30
8780,12,Haryana,25886840,17772039,8114801,2021-10-31 23:30
8781,13,Himachal Pradesh,9157473,5713695,3443778,2021-10-31 23:30
8782,14,Jammu and Kashmir,14657758,9511010,5146748,2021-10-31 23:30
8783,15,Jharkhand,20565938,14983565,5582373,2021-10-31 23:30
8784,16,Karnataka,65353525,42496209,22857316,2021-10-31 23:30
8785,17,Kerala,38964836,25306499,13658337,2021-10-31 23:30
8786,18,Ladakh,361078,208798,152280,2021-10-31 23:30
8787,19,Lakshadweep,101080,55129,45951,2021-10-31 23:30
8788,20,Madhya Pradesh,70748941,49911829,20837112,2021-10-31 23:30
8789,21,Maharashtra,98171089,67196330,30974759,2021-10-31 23:30
8790,22,Manipur,1968846,1249436,719410,2021-10-31 23:30
8791,23,Meghalaya,1745089,1103273,641816,2021-10-31 23:30
8792,24,Mizoram,1223612,711595,512017,2021-10-31 23:30
8793,25,Nagaland,1200202,709551,490651,2021-10-31 23:30
8794,26,Odisha,37294848,25735276,11559572,2021-10-31 23:30
8795,27,Puducherry,1138344,733957,404387,2021-10-31 23:30
8796,28,Punjab,22181312,15942523,6238789,2021-10-31 23:30
8797,29,Rajasthan,62637043,42543054,20093989,2021-10-31 23:30
8798,30,Sikkim,973272,521763,451509,2021-10-31 23:30
8799,31,Tamil Nadu,58895168,41277027,17618141,2021-10-31 23:30
8800,32,Telangana,32269369,22497488,9771881,2021-10-31 23:30
8801,33,Tripura,4129457,2508476,1620981,2021-10-31 23:30
8802,34,Uttar Pradesh,130854330,98175781,32678549,2021-10-31 23:30
8803,35,Uttarakhand,11376138,7477999,3898139,2021-10-31 23:30
8804,36,West Bengal,77741559,56183405,21558154,2021-10-31 23:30
8805,37,Daman and Diu,459681,272981,186700,2021-10-31 23:30
8806,1,Andaman and Nicobar Islands,495322,294097,201225,2021-11-01 23:30
8807,2,Andhra Pradesh,53567267,33049051,20518216,2021-11-01 23:30
8808,3,Arunachal Pradesh,1312670,773158,539512,2021-11-01 23:30
8809,4,Assam,28422572,20206410,8216162,2021-11-01 23:30
8810,5,Bihar,68499978,49981681,18518297,2021-11-01 23:30
8811,6,Chandigarh,1475630,926381,549249,2021-11-01 23:30
8812,7,Chhattisgarh,22247847,14867456,7380391,2021-11-01 23:30
8813,8,Dadra and Nagar Haveli,572941,387995,184946,2021-11-01 23:30
8814,9,Delhi,20534331,13076142,7458189,2021-11-01 23:30
8815,10,Goa,2181110,1263588,917522,2021-11-01 23:30
8816,11,Gujarat,71046122,44779212,26266910,2021-11-01 23:30
8817,12,Haryana,25918412,17782207,8136205,2021-11-01 23:30
8818,13,Himachal Pradesh,9203651,5716212,3487439,2021-11-01 23:30
8819,14,Jammu and Kashmir,14742431,9514941,5227490,2021-11-01 23:30
8820,15,Jharkhand,20689422,15037572,5651850,2021-11-01 23:30
8821,16,Karnataka,65477227,42534827,22942400,2021-11-01 23:30
8822,17,Kerala,39113588,25328172,13785416,2021-11-01 23:30
8823,18,Ladakh,361503,208872,152631,2021-11-01 23:30
8824,19,Lakshadweep,101308,55130,46178,2021-11-01 23:30
8825,20,Madhya Pradesh,71061227,49933129,21128098,2021-11-01 23:30
8826,21,Maharashtra,98525438,67386029,31139409,2021-11-01 23:30
8827,22,Manipur,1977488,1250255,727233,2021-11-01 23:30
8828,23,Meghalaya,1753800,1104841,648959,2021-11-01 23:30
8829,24,Mizoram,1226883,712131,514752,2021-11-01 23:30
8830,25,Nagaland,1204766,710447,494319,2021-11-01 23:30
8831,26,Odisha,37578030,25856054,11721976,2021-11-01 23:30
8832,27,Puducherry,1139470,734230,405240,2021-11-01 23:30
8833,28,Punjab,22226720,15960472,6266248,2021-11-01 23:30
8834,29,Rajasthan,62778118,42574175,20203943,2021-11-01 23:30
8835,30,Sikkim,974658,521855,452803,2021-11-01 23:30
8836,31,Tamil Nadu,58999816,41312515,17687301,2021-11-01 23:30
8837,32,Telangana,32580088,22666905,9913183,2021-11-01 23:30
8838,33,Tripura,4165233,2510531,1654702,2021-11-01 23:30
8839,34,Uttar Pradesh,131707494,98537599,33169895,2021-11-01 23:30
8840,35,Uttarakhand,11430294,7482278,3948016,2021-11-01 23:30
8841,36,West Bengal,78863112,56987338,21875774,2021-11-01 23:30
8842,37,Daman and Diu,461087,273261,187826,2021-11-01 23:30
8843,1,Andaman and Nicobar Islands,496307,294178,202129,2021-11-02 23:30
8844,2,Andhra Pradesh,53725733,33096924,20628809,2021-11-02 23:30
8845,3,Arunachal Pradesh,1317323,773805,543518,2021-11-02 23:30
8846,4,Assam,28577289,20233692,8343597,2021-11-02 23:30
8847,5,Bihar,68781680,50097890,18683790,2021-11-02 23:30
8848,6,Chandigarh,1477814,926717,551097,2021-11-02 23:30
8849,7,Chhattisgarh,22318077,14892622,7425455,2021-11-02 23:30
8850,8,Dadra and Nagar Haveli,574014,388099,185915,2021-11-02 23:30
8851,9,Delhi,20571468,13089983,7481485,2021-11-02 23:30
8852,10,Goa,2186120,1264234,921886,2021-11-02 23:30
8853,11,Gujarat,71342800,44820965,26521835,2021-11-02 23:30
8854,12,Haryana,25979149,17799239,8179910,2021-11-02 23:30
8855,13,Himachal Pradesh,9250977,5718525,3532452,2021-11-02 23:30
8856,14,Jammu and Kashmir,14840860,9518171,5322689,2021-11-02 23:30
8857,15,Jharkhand,20803223,15088671,5714552,2021-11-02 23:30
8858,16,Karnataka,65705434,42600931,23104503,2021-11-02 23:30
8859,17,Kerala,39282087,25349975,13932112,2021-11-02 23:30
8860,18,Ladakh,362079,209001,153078,2021-11-02 23:30
8861,19,Lakshadweep,101488,55138,46350,2021-11-02 23:30
8862,20,Madhya Pradesh,71180116,49944107,21236009,2021-11-02 23:30
8863,21,Maharashtra,98791772,67531502,31260270,2021-11-02 23:30
8864,22,Manipur,1988686,1251250,737436,2021-11-02 23:30
8865,23,Meghalaya,1762354,1106444,655910,2021-11-02 23:30
8866,24,Mizoram,1229384,712851,516533,2021-11-02 23:30
8867,25,Nagaland,1208765,711307,497458,2021-11-02 23:30
8868,26,Odisha,37860398,25970402,11889996,2021-11-02 23:30
8869,27,Puducherry,1141029,734562,406467,2021-11-02 23:30
8870,28,Punjab,22282449,15983231,6299218,2021-11-02 23:30
8871,29,Rajasthan,62910026,42601235,20308791,2021-11-02 23:30
8872,30,Sikkim,975364,521896,453468,2021-11-02 23:30
8873,31,Tamil Nadu,59134600,41357420,17777180,2021-11-02 23:30
8874,32,Telangana,32869119,22822087,10047032,2021-11-02 23:30
8875,33,Tripura,4201543,2512572,1688971,2021-11-02 23:30
8876,34,Uttar Pradesh,132373308,98833418,33539890,2021-11-02 23:30
8877,35,Uttarakhand,11468534,7485066,3983468,2021-11-02 23:30
8878,36,West Bengal,79585776,57481333,22104443,2021-11-02 23:30
8879,37,Daman and Diu,462134,273589,188545,2021-11-02 23:30
8880,1,Andaman and Nicobar Islands,497440,294269,203171,2021-11-03 23:30
8881,2,Andhra Pradesh,54111468,33221040,20890428,2021-11-03 23:30
8882,3,Arunachal Pradesh,1321339,774261,547078,2021-11-03 23:30
8883,4,Assam,28658635,20251699,8406936,2021-11-03 23:30
8884,5,Bihar,68999098,50188900,18810198,2021-11-03 23:30
8885,6,Chandigarh,1479199,926928,552271,2021-11-03 23:30
8886,7,Chhattisgarh,22390238,14917014,7473224,2021-11-03 23:30
8887,8,Dadra and Nagar Haveli,574852,388202,186650,2021-11-03 23:30
8888,9,Delhi,20593341,13098308,7495033,2021-11-03 23:30
8889,10,Goa,2190022,1264754,925268,2021-11-03 23:30
8890,11,Gujarat,71523686,44845601,26678085,2021-11-03 23:30
8891,12,Haryana,26017569,17809888,8207681,2021-11-03 23:30
8892,13,Himachal Pradesh,9296374,5720732,3575642,2021-11-03 23:30
8893,14,Jammu and Kashmir,14932678,9521841,5410837,2021-11-03 23:30
8894,15,Jharkhand,20903991,15132015,5771976,2021-11-03 23:30
8895,16,Karnataka,65782434,42625526,23156908,2021-11-03 23:30
8896,17,Kerala,39350266,25360598,13989668,2021-11-03 23:30
8897,18,Ladakh,363237,209115,154122,2021-11-03 23:30
8898,19,Lakshadweep,101619,55142,46477,2021-11-03 23:30
8899,20,Madhya Pradesh,71329750,49957703,21372047,2021-11-03 23:30
8900,21,Maharashtra,99026107,67657915,31368192,2021-11-03 23:30
8901,22,Manipur,1997296,1252013,745283,2021-11-03 23:30
8902,23,Meghalaya,1770141,1108260,661881,2021-11-03 23:30
8903,24,Mizoram,1231213,713156,518057,2021-11-03 23:30
8904,25,Nagaland,1212352,712018,500334,2021-11-03 23:30
8905,26,Odisha,38128193,26074710,12053483,2021-11-03 23:30
8906,27,Puducherry,1141798,734745,407053,2021-11-03 23:30
8907,28,Punjab,22307062,15992613,6314449,2021-11-03 23:30
8908,29,Rajasthan,62969377,42614342,20355035,2021-11-03 23:30
8909,30,Sikkim,975689,521915,453774,2021-11-03 23:30
8910,31,Tamil Nadu,59198080,41376734,17821346,2021-11-03 23:30
8911,32,Telangana,33099144,22944270,10154874,2021-11-03 23:30
8912,33,Tripura,4232986,2514444,1718542,2021-11-03 23:30
8913,34,Uttar Pradesh,132687846,98983370,33704476,2021-11-03 23:30
8914,35,Uttarakhand,11478664,7485804,3992860,2021-11-03 23:30
8915,36,West Bengal,80112078,57834574,22277504,2021-11-03 23:30
8916,37,Daman and Diu,463274,273857,189417,2021-11-03 23:30
8917,1,Andaman and Nicobar Islands,497451,294270,203181,2021-11-04 23:30
8918,2,Andhra Pradesh,54155435,33242004,20913431,2021-11-04 23:30
8919,3,Arunachal Pradesh,1322188,774360,547828,2021-11-04 23:30
8920,4,Assam,28703714,20260898,8442816,2021-11-04 23:30
8921,5,Bihar,69028115,50203633,18824482,2021-11-04 23:30
8922,6,Chandigarh,1479279,926937,552342,2021-11-04 23:30
8923,7,Chhattisgarh,22398817,14920117,7478700,2021-11-04 23:30
8924,8,Dadra and Nagar Haveli,574864,388202,186662,2021-11-04 23:30
8925,9,Delhi,20593488,13098346,7495142,2021-11-04 23:30
8926,10,Goa,2190045,1264767,925278,2021-11-04 23:30
8927,11,Gujarat,71541662,44848571,26693091,2021-11-04 23:30
8928,12,Haryana,26019739,17810700,8209039,2021-11-04 23:30
8929,13,Himachal Pradesh,9296609,5720733,3575876,2021-11-04 23:30
8930,14,Jammu and Kashmir,14978070,9523046,5455024,2021-11-04 23:30
8931,15,Jharkhand,20942347,15149857,5792490,2021-11-04 23:30
8932,16,Karnataka,65857577,42645233,23212344,2021-11-04 23:30
8933,17,Kerala,39402980,25367234,14035746,2021-11-04 23:30
8934,18,Ladakh,363254,209116,154138,2021-11-04 23:30
8935,19,Lakshadweep,101625,55142,46483,2021-11-04 23:30
8936,20,Madhya Pradesh,71339932,49958759,21381173,2021-11-04 23:30
8937,21,Maharashtra,99046341,67669173,31377168,2021-11-04 23:30
8938,22,Manipur,1999575,1252266,747309,2021-11-04 23:30
8939,23,Meghalaya,1778463,1110063,668400,2021-11-04 23:30
8940,24,Mizoram,1231628,713225,518403,2021-11-04 23:30
8941,25,Nagaland,1213159,712125,501034,2021-11-04 23:30
8942,26,Odisha,38268761,26128146,12140615,2021-11-04 23:30
8943,27,Puducherry,1141957,734770,407187,2021-11-04 23:30
8944,28,Punjab,22308712,15993491,6315221,2021-11-04 23:30
8945,29,Rajasthan,62974805,42615883,20358922,2021-11-04 23:30
8946,30,Sikkim,975727,521919,453808,2021-11-04 23:30
8947,31,Tamil Nadu,59209818,41380487,17829331,2021-11-04 23:30
8948,32,Telangana,33112933,22951804,10161129,2021-11-04 23:30
8949,33,Tripura,4234267,2514511,1719756,2021-11-04 23:30
8950,34,Uttar Pradesh,132721323,98998417,33722906,2021-11-04 23:30
8951,35,Uttarakhand,11479495,7485838,3993657,2021-11-04 23:30
8952,36,West Bengal,80253628,57928446,22325182,2021-11-04 23:30
8953,37,Daman and Diu,463277,273859,189418,2021-11-04 23:30
8954,1,Andaman and Nicobar Islands,500668,294362,206306,2021-11-05 23:30
8955,2,Andhra Pradesh,54495274,33339643,21155631,2021-11-05 23:30
8956,3,Arunachal Pradesh,1325234,774756,550478,2021-11-05 23:30
8957,4,Assam,28776145,20271521,8504624,2021-11-05 23:30
8958,5,Bihar,69164789,50252729,18912060,2021-11-05 23:30
8959,6,Chandigarh,1481355,927217,554138,2021-11-05 23:30
8960,7,Chhattisgarh,22405618,14921746,7483872,2021-11-05 23:30
8961,8,Dadra and Nagar Haveli,574985,388217,186768,2021-11-05 23:30
8962,9,Delhi,20635841,13111100,7524741,2021-11-05 23:30
8963,10,Goa,2195028,1265386,929642,2021-11-05 23:30
8964,11,Gujarat,71545077,44848917,26696160,2021-11-05 23:30
8965,12,Haryana,26027511,17812546,8214965,2021-11-05 23:30
8966,13,Himachal Pradesh,9340206,5722693,3617513,2021-11-05 23:30
8967,14,Jammu and Kashmir,15056182,9525962,5530220,2021-11-05 23:30
8968,15,Jharkhand,21010869,15176655,5834214,2021-11-05 23:30
8969,16,Karnataka,65891926,42652767,23239159,2021-11-05 23:30
8970,17,Kerala,39630620,25391828,14238792,2021-11-05 23:30
8971,18,Ladakh,364088,209225,154863,2021-11-05 23:30
8972,19,Lakshadweep,101747,55143,46604,2021-11-05 23:30
8973,20,Madhya Pradesh,71345708,49959250,21386458,2021-11-05 23:30
8974,21,Maharashtra,99077251,67679819,31397432,2021-11-05 23:30
8975,22,Manipur,2003645,1252720,750925,2021-11-05 23:30
8976,23,Meghalaya,1786244,1111718,674526,2021-11-05 23:30
8977,24,Mizoram,1234699,713640,521059,2021-11-05 23:30
8978,25,Nagaland,1216051,712614,503437,2021-11-05 23:30
8979,26,Odisha,38533435,26218228,12315207,2021-11-05 23:30
8980,27,Puducherry,1143547,735124,408423,2021-11-05 23:30
8981,28,Punjab,22311504,15994221,6317283,2021-11-05 23:30
8982,29,Rajasthan,62977674,42616285,20361389,2021-11-05 23:30
8983,30,Sikkim,975785,521923,453862,2021-11-05 23:30
8984,31,Tamil Nadu,59242166,41388476,17853690,2021-11-05 23:30
8985,32,Telangana,33334748,23058887,10275861,2021-11-05 23:30
8986,33,Tripura,4238887,2514901,1723986,2021-11-05 23:30
8987,34,Uttar Pradesh,132806158,99039862,33766296,2021-11-05 23:30
8988,35,Uttarakhand,11487836,7486322,4001514,2021-11-05 23:30
8989,36,West Bengal,80636954,58157722,22479232,2021-11-05 23:30
8990,37,Daman and Diu,463277,273859,189418,2021-11-05 23:30
8991,1,Andaman and Nicobar Islands,503986,294452,209534,2021-11-06 23:30
8992,2,Andhra Pradesh,54805672,33431379,21374293,2021-11-06 23:30
8993,3,Arunachal Pradesh,1327722,775088,552634,2021-11-06 23:30
8994,4,Assam,28901249,20287028,8614221,2021-11-06 23:30
8995,5,Bihar,69302219,50309167,18993052,2021-11-06 23:30
8996,6,Chandigarh,1484928,927689,557239,2021-11-06 23:30
8997,7,Chhattisgarh,22453280,14930335,7522945,2021-11-06 23:30
8998,8,Dadra and Nagar Haveli,576046,388321,187725,2021-11-06 23:30
8999,9,Delhi,20692840,13128308,7564532,2021-11-06 23:30
9000,10,Goa,2201286,1266053,935233,2021-11-06 23:30
9001,11,Gujarat,71567743,44852154,26715589,2021-11-06 23:30
9002,12,Haryana,26080472,17823474,8256998,2021-11-06 23:30
9003,13,Himachal Pradesh,9363265,5723600,3639665,2021-11-06 23:30
9004,14,Jammu and Kashmir,15135087,9528502,5606585,2021-11-06 23:30
9005,15,Jharkhand,21112320,15216525,5895795,2021-11-06 23:30
9006,16,Karnataka,66420414,42779428,23640986,2021-11-06 23:30
9007,17,Kerala,39802758,25408716,14394042,2021-11-06 23:30
9008,18,Ladakh,364784,209281,155503,2021-11-06 23:30
9009,19,Lakshadweep,101971,55147,46824,2021-11-06 23:30
9010,20,Madhya Pradesh,71510160,49970682,21539478,2021-11-06 23:30
9011,21,Maharashtra,99126745,67695928,31430817,2021-11-06 23:30
9012,22,Manipur,2004547,1252873,751674,2021-11-06 23:30
9013,23,Meghalaya,1792130,1112876,679254,2021-11-06 23:30
9014,24,Mizoram,1234793,713684,521109,2021-11-06 23:30
9015,25,Nagaland,1216751,712753,503998,2021-11-06 23:30
9016,26,Odisha,38817853,26310819,12507034,2021-11-06 23:30
9017,27,Puducherry,1147461,735922,411539,2021-11-06 23:30
9018,28,Punjab,22373257,16014428,6358829,2021-11-06 23:30
9019,29,Rajasthan,62991586,42618606,20372980,2021-11-06 23:30
9020,30,Sikkim,975871,521931,453940,2021-11-06 23:30
9021,31,Tamil Nadu,59489069,41449325,18039744,2021-11-06 23:30
9022,32,Telangana,33571343,23169120,10402223,2021-11-06 23:30
9023,33,Tripura,4246906,2515452,1731454,2021-11-06 23:30
9024,34,Uttar Pradesh,132978467,99098893,33879574,2021-11-06 23:30
9025,35,Uttarakhand,11497930,7486987,4010943,2021-11-06 23:30
9026,36,West Bengal,80698775,58191984,22506791,2021-11-06 23:30
9027,37,Daman and Diu,464294,274068,190226,2021-11-06 23:30
9028,1,Andaman and Nicobar Islands,504118,294452,209666,2021-11-07 23:30
9029,2,Andhra Pradesh,54830618,33441588,21389030,2021-11-07 23:30
9030,3,Arunachal Pradesh,1328178,775131,553047,2021-11-07 23:30
9031,4,Assam,28934652,20291406,8643246,2021-11-07 23:30
9032,5,Bihar,70775712,50824552,19951160,2021-11-07 23:30
9033,6,Chandigarh,1486698,927920,558778,2021-11-07 23:30
9034,7,Chhattisgarh,22501340,14937061,7564279,2021-11-07 23:30
9035,8,Dadra and Nagar Haveli,576047,388321,187726,2021-11-07 23:30
9036,9,Delhi,20737213,13143948,7593265,2021-11-07 23:30
9037,10,Goa,2208960,1267036,941924,2021-11-07 23:30
9038,11,Gujarat,71585774,44854813,26730961,2021-11-07 23:30
9039,12,Haryana,26122005,17832863,8289142,2021-11-07 23:30
9040,13,Himachal Pradesh,9377851,5724216,3653635,2021-11-07 23:30
9041,14,Jammu and Kashmir,15191415,9529543,5661872,2021-11-07 23:30
9042,15,Jharkhand,21223228,15264153,5959075,2021-11-07 23:30
9043,16,Karnataka,66469736,42796285,23673451,2021-11-07 23:30
9044,17,Kerala,39813699,25409763,14403936,2021-11-07 23:30
9045,18,Ladakh,364786,209283,155503,2021-11-07 23:30
9046,19,Lakshadweep,101979,55147,46832,2021-11-07 23:30
9047,20,Madhya Pradesh,71587206,49976412,21610794,2021-11-07 23:30
9048,21,Maharashtra,99173209,67713844,31459365,2021-11-07 23:30
9049,22,Manipur,2007185,1253332,753853,2021-11-07 23:30
9050,23,Meghalaya,1792369,1112926,679443,2021-11-07 23:30
9051,24,Mizoram,1234793,713684,521109,2021-11-07 23:30
9052,25,Nagaland,1217379,712898,504481,2021-11-07 23:30
9053,26,Odisha,38874453,26332930,12541523,2021-11-07 23:30
9054,27,Puducherry,1148288,736116,412172,2021-11-07 23:30
9055,28,Punjab,22393450,16021866,6371584,2021-11-07 23:30
9056,29,Rajasthan,63012404,42621326,20391078,2021-11-07 23:30
9057,30,Sikkim,975871,521931,453940,2021-11-07 23:30
9058,31,Tamil Nadu,59552112,41466026,18086086,2021-11-07 23:30
9059,32,Telangana,33597386,23182716,10414670,2021-11-07 23:30
9060,33,Tripura,4248608,2515459,1733149,2021-11-07 23:30
9061,34,Uttar Pradesh,133115258,99165322,33949936,2021-11-07 23:30
9062,35,Uttarakhand,11511693,7487978,4023715,2021-11-07 23:30
9063,36,West Bengal,80858982,58294445,22564537,2021-11-07 23:30
9064,37,Daman and Diu,464294,274068,190226,2021-11-07 23:30
9065,1,Andaman and Nicobar Islands,507672,294591,213081,2021-11-08 23:30
9066,2,Andhra Pradesh,55115094,33508785,21606309,2021-11-08 23:30
9067,3,Arunachal Pradesh,1333687,775720,557967,2021-11-08 23:30
9068,4,Assam,29164484,20316806,8847678,2021-11-08 23:30
9069,5,Bihar,70968573,50915752,20052821,2021-11-08 23:30
9070,6,Chandigarh,1490905,928503,562402,2021-11-08 23:30
9071,7,Chhattisgarh,22621545,14971267,7650278,2021-11-08 23:30
9072,8,Dadra and Nagar Haveli,577814,388538,189276,2021-11-08 23:30
9073,9,Delhi,20821219,13172030,7649189,2021-11-08 23:30
9074,10,Goa,2215343,1267855,947488,2021-11-08 23:30
9075,11,Gujarat,72004590,44886085,27118505,2021-11-08 23:30
9076,12,Haryana,26247345,17862700,8384645,2021-11-08 23:30
9077,13,Himachal Pradesh,9443040,5726913,3716127,2021-11-08 23:30
9078,14,Jammu and Kashmir,15273648,9533473,5740175,2021-11-08 23:30
9079,15,Jharkhand,21344452,15316970,6027482,2021-11-08 23:30
9080,16,Karnataka,66725558,42855331,23870227,2021-11-08 23:30
9081,17,Kerala,39978949,25425238,14553711,2021-11-08 23:30
9082,18,Ladakh,365747,209408,156339,2021-11-08 23:30
9083,19,Lakshadweep,102047,55154,46893,2021-11-08 23:30
9084,20,Madhya Pradesh,72003752,50004110,21999642,2021-11-08 23:30
9085,21,Maharashtra,99666895,67885898,31780997,2021-11-08 23:30
9086,22,Manipur,2017113,1254564,762549,2021-11-08 23:30
9087,23,Meghalaya,1803946,1115749,688197,2021-11-08 23:30
9088,24,Mizoram,1236969,713929,523040,2021-11-08 23:30
9089,25,Nagaland,1221829,713633,508196,2021-11-08 23:30
9090,26,Odisha,39149785,26421945,12727840,2021-11-08 23:30
9091,27,Puducherry,1149590,736350,413240,2021-11-08 23:30
9092,28,Punjab,22457122,16041664,6415458,2021-11-08 23:30
9093,29,Rajasthan,63176537,42648246,20528291,2021-11-08 23:30
9094,30,Sikkim,976670,521967,454703,2021-11-08 23:30
9095,31,Tamil Nadu,59651684,41491232,18160452,2021-11-08 23:30
9096,32,Telangana,33826696,23284789,10541907,2021-11-08 23:30
9097,33,Tripura,4265272,2516486,1748786,2021-11-08 23:30
9098,34,Uttar Pradesh,134200742,99557532,34643210,2021-11-08 23:30
9099,35,Uttarakhand,11560594,7491715,4068879,2021-11-08 23:30
9100,36,West Bengal,81803641,58811559,22992082,2021-11-08 23:30
9101,37,Daman and Diu,466438,274373,192065,2021-11-08 23:30
9102,1,Andaman and Nicobar Islands,510452,294740,215712,2021-11-09 23:30
9103,2,Andhra Pradesh,55352920,33560819,21792101,2021-11-09 23:30
9104,3,Arunachal Pradesh,1336674,776188,560486,2021-11-09 23:30
9105,4,Assam,29376918,20343107,9033811,2021-11-09 23:30
9106,5,Bihar,71062153,50969090,20093063,2021-11-09 23:30
9107,6,Chandigarh,1494774,929037,565737,2021-11-09 23:30
9108,7,Chhattisgarh,22735684,15004771,7730913,2021-11-09 23:30
9109,8,Dadra and Nagar Haveli,579841,388727,191114,2021-11-09 23:30
9110,9,Delhi,20906805,13201053,7705752,2021-11-09 23:30
9111,10,Goa,2220912,1268647,952265,2021-11-09 23:30
9112,11,Gujarat,72493675,44921489,27572186,2021-11-09 23:30
9113,12,Haryana,26379718,17898259,8481459,2021-11-09 23:30
9114,13,Himachal Pradesh,9513647,5729932,3783715,2021-11-09 23:30
9115,14,Jammu and Kashmir,15362705,9537009,5825696,2021-11-09 23:30
9116,15,Jharkhand,21456935,15367577,6089358,2021-11-09 23:30
9117,16,Karnataka,66934080,42904393,24029687,2021-11-09 23:30
9118,17,Kerala,40232354,25445772,14786582,2021-11-09 23:30
9119,18,Ladakh,366631,209535,157096,2021-11-09 23:30
9120,19,Lakshadweep,102194,55155,47039,2021-11-09 23:30
9121,20,Madhya Pradesh,72194368,50019667,22174701,2021-11-09 23:30
9122,21,Maharashtra,100145378,68062479,32082899,2021-11-09 23:30
9123,22,Manipur,2024979,1255722,769257,2021-11-09 23:30
9124,23,Meghalaya,1815431,1118445,696986,2021-11-09 23:30
9125,24,Mizoram,1239181,714284,524897,2021-11-09 23:30
9126,25,Nagaland,1225089,714262,510827,2021-11-09 23:30
9127,26,Odisha,39414441,26506877,12907564,2021-11-09 23:30
9128,27,Puducherry,1152244,736941,415303,2021-11-09 23:30
9129,28,Punjab,22551818,16072399,6479419,2021-11-09 23:30
9130,29,Rajasthan,63386074,42684630,20701444,2021-11-09 23:30
9131,30,Sikkim,977956,522043,455913,2021-11-09 23:30
9132,31,Tamil Nadu,59785543,41528983,18256560,2021-11-09 23:30
9133,32,Telangana,34045728,23381806,10663922,2021-11-09 23:30
9134,33,Tripura,4285047,2517525,1767522,2021-11-09 23:30
9135,34,Uttar Pradesh,135283568,99970030,35313538,2021-11-09 23:30
9136,35,Uttarakhand,11621198,7496185,4125013,2021-11-09 23:30
9137,36,West Bengal,82498593,59154088,23344505,2021-11-09 23:30
9138,37,Daman and Diu,468192,274680,193512,2021-11-09 23:30
9139,1,Andaman and Nicobar Islands,512388,294862,217526,2021-11-10 23:30
9140,2,Andhra Pradesh,55531761,33602408,21929353,2021-11-10 23:30
9141,3,Arunachal Pradesh,1340189,776732,563457,2021-11-10 23:30
9142,4,Assam,29493103,20360680,9132423,2021-11-10 23:30
9143,5,Bihar,71107234,50996455,20110779,2021-11-10 23:30
9144,6,Chandigarh,1498359,929530,568829,2021-11-10 23:30
9145,7,Chhattisgarh,22819132,15032447,7786685,2021-11-10 23:30
9146,8,Dadra and Nagar Haveli,581117,388907,192210,2021-11-10 23:30
9147,9,Delhi,20966379,13220737,7745642,2021-11-10 23:30
9148,10,Goa,2225655,1269204,956451,2021-11-10 23:30
9149,11,Gujarat,72894846,44957228,27937618,2021-11-10 23:30
9150,12,Haryana,26491416,17926089,8565327,2021-11-10 23:30
9151,13,Himachal Pradesh,9581976,5732867,3849109,2021-11-10 23:30
9152,14,Jammu and Kashmir,15449022,9540804,5908218,2021-11-10 23:30
9153,15,Jharkhand,21517720,15398281,6119439,2021-11-10 23:30
9154,16,Karnataka,67557338,43046239,24511099,2021-11-10 23:30
9155,17,Kerala,40308656,25453735,14854921,2021-11-10 23:30
9156,18,Ladakh,367436,209636,157800,2021-11-10 23:30
9157,19,Lakshadweep,102249,55157,47092,2021-11-10 23:30
9158,20,Madhya Pradesh,73597462,50113313,23484149,2021-11-10 23:30
9159,21,Maharashtra,100657080,68271801,32385279,2021-11-10 23:30
9160,22,Manipur,2033153,1256929,776224,2021-11-10 23:30
9161,23,Meghalaya,1822997,1120145,702852,2021-11-10 23:30
9162,24,Mizoram,1241898,715098,526800,2021-11-10 23:30
9163,25,Nagaland,1227648,714757,512891,2021-11-10 23:30
9164,26,Odisha,39646908,26580173,13066735,2021-11-10 23:30
9165,27,Puducherry,1153807,737274,416533,2021-11-10 23:30
9166,28,Punjab,22603795,16088511,6515284,2021-11-10 23:30
9167,29,Rajasthan,63599312,42721092,20878220,2021-11-10 23:30
9168,30,Sikkim,978539,522081,456458,2021-11-10 23:30
9169,31,Tamil Nadu,59895330,41562400,18332930,2021-11-10 23:30
9170,32,Telangana,34204424,23451643,10752781,2021-11-10 23:30
9171,33,Tripura,4298931,2518308,1780623,2021-11-10 23:30
9172,34,Uttar Pradesh,136100647,100293400,35807247,2021-11-10 23:30
9173,35,Uttarakhand,11660576,7499275,4161301,2021-11-10 23:30
9174,36,West Bengal,82972610,59380535,23592075,2021-11-10 23:30
9175,37,Daman and Diu,468237,274683,193554,2021-11-10 23:30
9176,1,Andaman and Nicobar Islands,513906,294950,218956,2021-11-11 23:30
9177,2,Andhra Pradesh,55699855,33639627,22060228,2021-11-11 23:30
9178,3,Arunachal Pradesh,1343828,777463,566365,2021-11-11 23:30
9179,4,Assam,29691233,20388731,9302502,2021-11-11 23:30
9180,5,Bihar,71145445,51013684,20131761,2021-11-11 23:30
9181,6,Chandigarh,1501887,930008,571879,2021-11-11 23:30
9182,7,Chhattisgarh,22958495,15085930,7872565,2021-11-11 23:30
9183,8,Dadra and Nagar Haveli,582820,389107,193713,2021-11-11 23:30
9184,9,Delhi,21047519,13249404,7798115,2021-11-11 23:30
9185,10,Goa,2230113,1269763,960350,2021-11-11 23:30
9186,11,Gujarat,73359252,44992418,28366834,2021-11-11 23:30
9187,12,Haryana,26596477,17952075,8644402,2021-11-11 23:30
9188,13,Himachal Pradesh,9658525,5736545,3921980,2021-11-11 23:30
9189,14,Jammu and Kashmir,15569370,9544515,6024855,2021-11-11 23:30
9190,15,Jharkhand,21588511,15430258,6158253,2021-11-11 23:30
9191,16,Karnataka,67719324,43089694,24629630,2021-11-11 23:30
9192,17,Kerala,40528282,25471802,15056480,2021-11-11 23:30
9193,18,Ladakh,368115,209732,158383,2021-11-11 23:30
9194,19,Lakshadweep,102358,55164,47194,2021-11-11 23:30
9195,20,Madhya Pradesh,74302461,50166449,24136012,2021-11-11 23:30
9196,21,Maharashtra,101213009,68520368,32692641,2021-11-11 23:30
9197,22,Manipur,2040399,1258048,782351,2021-11-11 23:30
9198,23,Meghalaya,1834942,1123334,711608,2021-11-11 23:30
9199,24,Mizoram,1244912,716112,528800,2021-11-11 23:30
9200,25,Nagaland,1229793,715225,514568,2021-11-11 23:30
9201,26,Odisha,39882261,26659470,13222791,2021-11-11 23:30
9202,27,Puducherry,1155641,737610,418031,2021-11-11 23:30
9203,28,Punjab,22706407,16120350,6586057,2021-11-11 23:30
9204,29,Rajasthan,63795734,42758316,21037418,2021-11-11 23:30
9205,30,Sikkim,980086,522193,457893,2021-11-11 23:30
9206,31,Tamil Nadu,60084376,41620812,18463564,2021-11-11 23:30
9207,32,Telangana,34382356,23527102,10855254,2021-11-11 23:30
9208,33,Tripura,4319277,2519662,1799615,2021-11-11 23:30
9209,34,Uttar Pradesh,137292413,100749910,36542503,2021-11-11 23:30
9210,35,Uttarakhand,11715188,7503650,4211538,2021-11-11 23:30
9211,36,West Bengal,83265029,59497170,23767859,2021-11-11 23:30
9212,37,Daman and Diu,469947,274975,194972,2021-11-11 23:30
9213,1,Andaman and Nicobar Islands,515720,295044,220676,2021-11-12 23:30
9214,2,Andhra Pradesh,55932834,33694222,22238612,2021-11-12 23:30
9215,3,Arunachal Pradesh,1347679,778306,569373,2021-11-12 23:30
9216,4,Assam,29898716,20422690,9476026,2021-11-12 23:30
9217,5,Bihar,71332230,51076122,20256108,2021-11-12 23:30
9218,6,Chandigarh,1505856,930547,575309,2021-11-12 23:30
9219,7,Chhattisgarh,23096445,15139868,7956577,2021-11-12 23:30
9220,8,Dadra and Nagar Haveli,585431,389367,196064,2021-11-12 23:30
9221,9,Delhi,21126018,13276317,7849701,2021-11-12 23:30
9222,10,Goa,2234417,1270323,964094,2021-11-12 23:30
9223,11,Gujarat,73775003,45027580,28747423,2021-11-12 23:30
9224,12,Haryana,26701833,17979501,8722332,2021-11-12 23:30
9225,13,Himachal Pradesh,9733967,5740099,3993868,2021-11-12 23:30
9226,14,Jammu and Kashmir,15677363,9547802,6129561,2021-11-12 23:30
9227,15,Jharkhand,21722584,15484178,6238406,2021-11-12 23:30
9228,16,Karnataka,67937302,43145669,24791633,2021-11-12 23:30
9229,17,Kerala,40753973,25489633,15264340,2021-11-12 23:30
9230,18,Ladakh,368761,209826,158935,2021-11-12 23:30
9231,19,Lakshadweep,102586,55195,47391,2021-11-12 23:30
9232,20,Madhya Pradesh,74738723,50204856,24533867,2021-11-12 23:30
9233,21,Maharashtra,101804853,68794617,33010236,2021-11-12 23:30
9234,22,Manipur,2048782,1259535,789247,2021-11-12 23:30
9235,23,Meghalaya,1844242,1125636,718606,2021-11-12 23:30
9236,24,Mizoram,1248948,717151,531797,2021-11-12 23:30
9237,25,Nagaland,1232552,716003,516549,2021-11-12 23:30
9238,26,Odisha,40091282,26734491,13356791,2021-11-12 23:30
9239,27,Puducherry,1159139,738467,420672,2021-11-12 23:30
9240,28,Punjab,22776833,16142757,6634076,2021-11-12 23:30
9241,29,Rajasthan,64026667,42800917,21225750,2021-11-12 23:30
9242,30,Sikkim,981749,522323,459426,2021-11-12 23:30
9243,31,Tamil Nadu,60373971,41721178,18652793,2021-11-12 23:30
9244,32,Telangana,34583835,23613201,10970634,2021-11-12 23:30
9245,33,Tripura,4332515,2520512,1812003,2021-11-12 23:30
9246,34,Uttar Pradesh,138598580,101260577,37338003,2021-11-12 23:30
9247,35,Uttarakhand,11773659,7508188,4265471,2021-11-12 23:30
9248,36,West Bengal,83780198,59731921,24048277,2021-11-12 23:30
9249,37,Daman and Diu,471646,275349,196297,2021-11-12 23:30
9250,1,Andaman and Nicobar Islands,517624,295160,222464,2021-11-13 23:30
9251,2,Andhra Pradesh,56090352,33733546,22356806,2021-11-13 23:30
9252,3,Arunachal Pradesh,1350725,779021,571704,2021-11-13 23:30
9253,4,Assam,30095644,20459991,9635653,2021-11-13 23:30
9254,5,Bihar,71623272,51175908,20447364,2021-11-13 23:30
9255,6,Chandigarh,1511410,931284,580126,2021-11-13 23:30
9256,7,Chhattisgarh,23244860,15202608,8042252,2021-11-13 23:30
9257,8,Dadra and Nagar Haveli,588441,389712,198729,2021-11-13 23:30
9258,9,Delhi,21239500,13314376,7925124,2021-11-13 23:30
9259,10,Goa,2243370,1271702,971668,2021-11-13 23:30
9260,11,Gujarat,74205783,45064701,29141082,2021-11-13 23:30
9261,12,Haryana,26805747,18008076,8797671,2021-11-13 23:30
9262,13,Himachal Pradesh,9815067,5744194,4070873,2021-11-13 23:30
9263,14,Jammu and Kashmir,15769390,9551400,6217990,2021-11-13 23:30
9264,15,Jharkhand,21845221,15536829,6308392,2021-11-13 23:30
9265,16,Karnataka,68092327,43183142,24909185,2021-11-13 23:30
9266,17,Kerala,40840705,25496072,15344633,2021-11-13 23:30
9267,18,Ladakh,369525,209948,159577,2021-11-13 23:30
9268,19,Lakshadweep,102739,55212,47527,2021-11-13 23:30
9269,20,Madhya Pradesh,75434506,50261399,25173107,2021-11-13 23:30
9270,21,Maharashtra,102508340,69091959,33416381,2021-11-13 23:30
9271,22,Manipur,2056733,1261028,795705,2021-11-13 23:30
9272,23,Meghalaya,1851835,1127481,724354,2021-11-13 23:30
9273,24,Mizoram,1250338,717955,532383,2021-11-13 23:30
9274,25,Nagaland,1233597,716315,517282,2021-11-13 23:30
9275,26,Odisha,40297055,26805870,13491185,2021-11-13 23:30
9276,27,Puducherry,1163747,739574,424173,2021-11-13 23:30
9277,28,Punjab,22885946,16176736,6709210,2021-11-13 23:30
9278,29,Rajasthan,64270834,42849998,21420836,2021-11-13 23:30
9279,30,Sikkim,982098,522359,459739,2021-11-13 23:30
9280,31,Tamil Nadu,60709672,41833746,18875926,2021-11-13 23:30
9281,32,Telangana,34778805,23693122,11085683,2021-11-13 23:30
9282,33,Tripura,4350269,2521834,1828435,2021-11-13 23:30
9283,34,Uttar Pradesh,139675994,101672251,38003743,2021-11-13 23:30
9284,35,Uttarakhand,11828999,7512784,4316215,2021-11-13 23:30
9285,36,West Bengal,84167304,59912186,24255118,2021-11-13 23:30
9286,37,Daman and Diu,473813,275725,198088,2021-11-13 23:30
9287,1,Andaman and Nicobar Islands,518138,295192,222946,2021-11-14 23:30
9288,2,Andhra Pradesh,56101964,33737933,22364031,2021-11-14 23:30
9289,3,Arunachal Pradesh,1351152,779111,572041,2021-11-14 23:30
9290,4,Assam,30164860,20474567,9690293,2021-11-14 23:30
9291,5,Bihar,71810611,51252944,20557667,2021-11-14 23:30
9292,6,Chandigarh,1513403,931530,581873,2021-11-14 23:30
9293,7,Chhattisgarh,23335419,15241386,8094033,2021-11-14 23:30
9294,8,Dadra and Nagar Haveli,588601,389729,198872,2021-11-14 23:30
9295,9,Delhi,21256580,13321932,7934648,2021-11-14 23:30
9296,10,Goa,2247268,1272176,975092,2021-11-14 23:30
9297,11,Gujarat,74347982,45080210,29267772,2021-11-14 23:30
9298,12,Haryana,26851244,18023055,8828189,2021-11-14 23:30
9299,13,Himachal Pradesh,9847798,5745755,4102043,2021-11-14 23:30
9300,14,Jammu and Kashmir,15814646,9552446,6262200,2021-11-14 23:30
9301,15,Jharkhand,21975781,15593775,6382006,2021-11-14 23:30
9302,16,Karnataka,68133746,43196175,24937571,2021-11-14 23:30
9303,17,Kerala,40851569,25497004,15354565,2021-11-14 23:30
9304,18,Ladakh,369551,209949,159602,2021-11-14 23:30
9305,19,Lakshadweep,102748,55212,47536,2021-11-14 23:30
9306,20,Madhya Pradesh,75619267,50277175,25342092,2021-11-14 23:30
9307,21,Maharashtra,102663952,69171669,33492283,2021-11-14 23:30
9308,22,Manipur,2059858,1261846,798012,2021-11-14 23:30
9309,23,Meghalaya,1852458,1127652,724806,2021-11-14 23:30
9310,24,Mizoram,1250710,718085,532625,2021-11-14 23:30
9311,25,Nagaland,1235745,717342,518403,2021-11-14 23:30
9312,26,Odisha,40345696,26823917,13521779,2021-11-14 23:30
9313,27,Puducherry,1164522,739741,424781,2021-11-14 23:30
9314,28,Punjab,22908389,16185106,6723283,2021-11-14 23:30
9315,29,Rajasthan,64318806,42860458,21458348,2021-11-14 23:30
9316,30,Sikkim,982098,522359,459739,2021-11-14 23:30
9317,31,Tamil Nadu,61984693,42194444,19790249,2021-11-14 23:30
9318,32,Telangana,34809287,23704112,11105175,2021-11-14 23:30
9319,33,Tripura,4358267,2522197,1836070,2021-11-14 23:30
9320,34,Uttar Pradesh,140222340,101924986,38297354,2021-11-14 23:30
9321,35,Uttarakhand,11850537,7514213,4336324,2021-11-14 23:30
9322,36,West Bengal,84274356,59975354,24299002,2021-11-14 23:30
9323,37,Daman and Diu,473813,275725,198088,2021-11-14 23:30
9324,1,Andaman and Nicobar Islands,520830,295332,225498,2021-11-15 23:30
9325,2,Andhra Pradesh,56294178,33777863,22516315,2021-11-15 23:30
9326,3,Arunachal Pradesh,1356317,780468,575849,2021-11-15 23:30
9327,4,Assam,30423468,20527072,9896396,2021-11-15 23:30
9328,5,Bihar,72049629,51338695,20710934,2021-11-15 23:30
9329,6,Chandigarh,1517746,932155,585591,2021-11-15 23:30
9330,7,Chhattisgarh,23461487,15291386,8170101,2021-11-15 23:30
9331,8,Dadra and Nagar Haveli,591859,390186,201673,2021-11-15 23:30
9332,9,Delhi,21371137,13364684,8006453,2021-11-15 23:30
9333,10,Goa,2251505,1272756,978749,2021-11-15 23:30
9334,11,Gujarat,74832186,45125055,29707131,2021-11-15 23:30
9335,12,Haryana,26965534,18056116,8909418,2021-11-15 23:30
9336,13,Himachal Pradesh,9935817,5750860,4184957,2021-11-15 23:30
9337,14,Jammu and Kashmir,15891662,9556063,6335599,2021-11-15 23:30
9338,15,Jharkhand,22152698,15669032,6483666,2021-11-15 23:30
9339,16,Karnataka,68354356,43249486,25104870,2021-11-15 23:30
9340,17,Kerala,41048855,25514641,15534214,2021-11-15 23:30
9341,18,Ladakh,370447,210106,160341,2021-11-15 23:30
9342,19,Lakshadweep,103005,55270,47735,2021-11-15 23:30
9343,20,Madhya Pradesh,75930757,50300799,25629958,2021-11-15 23:30
9344,21,Maharashtra,103402393,69491442,33910951,2021-11-15 23:30
9345,22,Manipur,2068763,1263294,805469,2021-11-15 23:30
9346,23,Meghalaya,1864334,1130723,733611,2021-11-15 23:30
9347,24,Mizoram,1253040,719047,533993,2021-11-15 23:30
9348,25,Nagaland,1239894,718546,521348,2021-11-15 23:30
9349,26,Odisha,40564943,26897726,13667217,2021-11-15 23:30
9350,27,Puducherry,1168759,740836,427923,2021-11-15 23:30
9351,28,Punjab,22999000,16215957,6783043,2021-11-15 23:30
9352,29,Rajasthan,64500425,42894261,21606164,2021-11-15 23:30
9353,30,Sikkim,983423,522481,460942,2021-11-15 23:30
9354,31,Tamil Nadu,62229987,42289200,19940787,2021-11-15 23:30
9355,32,Telangana,35023302,23785801,11237501,2021-11-15 23:30
9356,33,Tripura,4379256,2524095,1855161,2021-11-15 23:30
9357,34,Uttar Pradesh,141475009,102434970,39040039,2021-11-15 23:30
9358,35,Uttarakhand,11895945,7517761,4378184,2021-11-15 23:30
9359,36,West Bengal,84904949,60296612,24608337,2021-11-15 23:30
9360,37,Daman and Diu,475887,276129,199758,2021-11-15 23:30
9361,1,Andaman and Nicobar Islands,523394,295452,227942,2021-11-16 23:30
9362,2,Andhra Pradesh,56483296,33815570,22667726,2021-11-16 23:30
9363,3,Arunachal Pradesh,1360273,781499,578774,2021-11-16 23:30
9364,4,Assam,30676357,20579901,10096456,2021-11-16 23:30
9365,5,Bihar,72753646,51592410,21161236,2021-11-16 23:30
9366,6,Chandigarh,1521514,932703,588811,2021-11-16 23:30
9367,7,Chhattisgarh,23587554,15345196,8242358,2021-11-16 23:30
9368,8,Dadra and Nagar Haveli,595281,390635,204646,2021-11-16 23:30
9369,9,Delhi,21471908,13403714,8068194,2021-11-16 23:30
9370,10,Goa,2255709,1273307,982402,2021-11-16 23:30
9371,11,Gujarat,75335927,45178808,30157119,2021-11-16 23:30
9372,12,Haryana,27091603,18094753,8996850,2021-11-16 23:30
9373,13,Himachal Pradesh,10030131,5756517,4273614,2021-11-16 23:30
9374,14,Jammu and Kashmir,15962843,9559678,6403165,2021-11-16 23:30
9375,15,Jharkhand,22323184,15742135,6581049,2021-11-16 23:30
9376,16,Karnataka,68579180,43303771,25275409,2021-11-16 23:30
9377,17,Kerala,41283549,25533634,15749915,2021-11-16 23:30
9378,18,Ladakh,371446,210255,161191,2021-11-16 23:30
9379,19,Lakshadweep,103282,55312,47970,2021-11-16 23:30
9380,20,Madhya Pradesh,76317917,50336712,25981205,2021-11-16 23:30
9381,21,Maharashtra,104114580,69813639,34300941,2021-11-16 23:30
9382,22,Manipur,2076059,1264528,811531,2021-11-16 23:30
9383,23,Meghalaya,1876990,1134338,742652,2021-11-16 23:30
9384,24,Mizoram,1256941,720297,536644,2021-11-16 23:30
9385,25,Nagaland,1243572,719920,523652,2021-11-16 23:30
9386,26,Odisha,40789539,26971394,13818145,2021-11-16 23:30
9387,27,Puducherry,1173381,742065,431316,2021-11-16 23:30
9388,28,Punjab,23101859,16249331,6852528,2021-11-16 23:30
9389,29,Rajasthan,64720478,42933308,21787170,2021-11-16 23:30
9390,30,Sikkim,984534,522598,461936,2021-11-16 23:30
9391,31,Tamil Nadu,62586374,42424664,20161710,2021-11-16 23:30
9392,32,Telangana,35258554,23881125,11377429,2021-11-16 23:30
9393,33,Tripura,4398930,2525698,1873232,2021-11-16 23:30
9394,34,Uttar Pradesh,142916432,103026339,39890093,2021-11-16 23:30
9395,35,Uttarakhand,11956020,7522806,4433214,2021-11-16 23:30
9396,36,West Bengal,85467478,60554889,24912589,2021-11-16 23:30
9397,37,Daman and Diu,477491,276450,201041,2021-11-16 23:30
9398,1,Andaman and Nicobar Islands,526195,295585,230610,2021-11-17 23:30
9399,2,Andhra Pradesh,56637846,33847241,22790605,2021-11-17 23:30
9400,3,Arunachal Pradesh,1364380,782713,581667,2021-11-17 23:30
9401,4,Assam,30836207,20618869,10217338,2021-11-17 23:30
9402,5,Bihar,73150918,51737796,21413122,2021-11-17 23:30
9403,6,Chandigarh,1525093,933260,591833,2021-11-17 23:30
9404,7,Chhattisgarh,23742400,15416604,8325796,2021-11-17 23:30
9405,8,Dadra and Nagar Haveli,597880,391080,206800,2021-11-17 23:30
9406,9,Delhi,21552627,13436098,8116529,2021-11-17 23:30
9407,10,Goa,2259827,1273897,985930,2021-11-17 23:30
9408,11,Gujarat,75760375,45229972,30530403,2021-11-17 23:30
9409,12,Haryana,27195009,18127532,9067477,2021-11-17 23:30
9410,13,Himachal Pradesh,10118591,5762274,4356317,2021-11-17 23:30
9411,14,Jammu and Kashmir,16019879,9562927,6456952,2021-11-17 23:30
9412,15,Jharkhand,22485296,15807992,6677304,2021-11-17 23:30
9413,16,Karnataka,69300118,43451332,25848786,2021-11-17 23:30
9414,17,Kerala,41354351,25540883,15813468,2021-11-17 23:30
9415,18,Ladakh,372334,210399,161935,2021-11-17 23:30
9416,19,Lakshadweep,103411,55332,48079,2021-11-17 23:30
9417,20,Madhya Pradesh,78073813,50461303,27612510,2021-11-17 23:30
9418,21,Maharashtra,104791670,70129261,34662409,2021-11-17 23:30
9419,22,Manipur,2083949,1265968,817981,2021-11-17 23:30
9420,23,Meghalaya,1884511,1136282,748229,2021-11-17 23:30
9421,24,Mizoram,1262175,721734,540441,2021-11-17 23:30
9422,25,Nagaland,1247024,721107,525917,2021-11-17 23:30
9423,26,Odisha,40997716,27043709,13954007,2021-11-17 23:30
9424,27,Puducherry,1177268,743115,434153,2021-11-17 23:30
9425,28,Punjab,23171360,16271783,6899577,2021-11-17 23:30
9426,29,Rajasthan,64918289,42967966,21950323,2021-11-17 23:30
9427,30,Sikkim,985540,522682,462858,2021-11-17 23:30
9428,31,Tamil Nadu,62955389,42572736,20382653,2021-11-17 23:30
9429,32,Telangana,35451430,23961447,11489983,2021-11-17 23:30
9430,33,Tripura,4412949,2526928,1886021,2021-11-17 23:30
9431,34,Uttar Pradesh,143987555,103489402,40498153,2021-11-17 23:30
9432,35,Uttarakhand,12009845,7527418,4482427,2021-11-17 23:30
9433,36,West Bengal,85940800,60758167,25182633,2021-11-17 23:30
9434,37,Daman and Diu,479188,276843,202345,2021-11-17 23:30
9435,1,Andaman and Nicobar Islands,529448,295679,233769,2021-11-18 23:30
9436,2,Andhra Pradesh,56796751,33876594,22920157,2021-11-18 23:30
9437,3,Arunachal Pradesh,1368329,783978,584351,2021-11-18 23:30
9438,4,Assam,31077916,20675678,10402238,2021-11-18 23:30
9439,5,Bihar,73793037,51982827,21810210,2021-11-18 23:30
9440,6,Chandigarh,1529065,933940,595125,2021-11-18 23:30
9441,7,Chhattisgarh,24009115,15542994,8466121,2021-11-18 23:30
9442,8,Dadra and Nagar Haveli,601081,391511,209570,2021-11-18 23:30
9443,9,Delhi,21649305,13474370,8174935,2021-11-18 23:30
9444,10,Goa,2263460,1274409,989051,2021-11-18 23:30
9445,11,Gujarat,76261145,45288291,30972854,2021-11-18 23:30
9446,12,Haryana,27327209,18172511,9154698,2021-11-18 23:30
9447,13,Himachal Pradesh,10201818,5767729,4434089,2021-11-18 23:30
9448,14,Jammu and Kashmir,16067919,9566012,6501907,2021-11-18 23:30
9449,15,Jharkhand,22631555,15867943,6763612,2021-11-18 23:30
9450,16,Karnataka,69569805,43523186,26046619,2021-11-18 23:30
9451,17,Kerala,41544077,25556489,15987588,2021-11-18 23:30
9452,18,Ladakh,373648,210549,163099,2021-11-18 23:30
9453,19,Lakshadweep,103608,55335,48273,2021-11-18 23:30
9454,20,Madhya Pradesh,78883731,50519880,28363851,2021-11-18 23:30
9455,21,Maharashtra,105474625,70448754,35025871,2021-11-18 23:30
9456,22,Manipur,2090558,1267226,823332,2021-11-18 23:30
9457,23,Meghalaya,1895473,1139227,756246,2021-11-18 23:30
9458,24,Mizoram,1266008,723030,542978,2021-11-18 23:30
9459,25,Nagaland,1249494,721886,527608,2021-11-18 23:30
9460,26,Odisha,41207940,27117826,14090114,2021-11-18 23:30
9461,27,Puducherry,1178222,743341,434881,2021-11-18 23:30
9462,28,Punjab,23260434,16299453,6960981,2021-11-18 23:30
9463,29,Rajasthan,65094033,42998156,22095877,2021-11-18 23:30
9464,30,Sikkim,986824,522764,464060,2021-11-18 23:30
9465,31,Tamil Nadu,63707763,42871712,20836051,2021-11-18 23:30
9466,32,Telangana,35702538,24057437,11645101,2021-11-18 23:30
9467,33,Tripura,4431526,2528677,1902849,2021-11-18 23:30
9468,34,Uttar Pradesh,145454830,104121352,41333478,2021-11-18 23:30
9469,35,Uttarakhand,12064431,7531965,4532466,2021-11-18 23:30
9470,36,West Bengal,86288616,60895552,25393064,2021-11-18 23:30
9471,37,Daman and Diu,480518,277142,203376,2021-11-18 23:30
9472,1,Andaman and Nicobar Islands,530273,295693,234580,2021-11-19 23:30
9473,2,Andhra Pradesh,56933969,33899630,23034339,2021-11-19 23:30
9474,3,Arunachal Pradesh,1370304,784686,585618,2021-11-19 23:30
9475,4,Assam,31304711,20730478,10574233,2021-11-19 23:30
9476,5,Bihar,74253599,52158443,22095156,2021-11-19 23:30
9477,6,Chandigarh,1530796,934205,596591,2021-11-19 23:30
9478,7,Chhattisgarh,24149401,15613224,8536177,2021-11-19 23:30
9479,8,Dadra and Nagar Haveli,603941,391941,212000,2021-11-19 23:30
9480,9,Delhi,21720677,13500766,8219911,2021-11-19 23:30
9481,10,Goa,2266996,1274909,992087,2021-11-19 23:30
9482,11,Gujarat,76589736,45329277,31260459,2021-11-19 23:30
9483,12,Haryana,27398934,18201208,9197726,2021-11-19 23:30
9484,13,Himachal Pradesh,10267476,5771818,4495658,2021-11-19 23:30
9485,14,Jammu and Kashmir,16102518,9568192,6534326,2021-11-19 23:30
9486,15,Jharkhand,22781841,15930254,6851587,2021-11-19 23:30
9487,16,Karnataka,69899243,43604974,26294269,2021-11-19 23:30
9488,17,Kerala,41721422,25570815,16150607,2021-11-19 23:30
9489,18,Ladakh,373694,210562,163132,2021-11-19 23:30
9490,19,Lakshadweep,103703,55337,48366,2021-11-19 23:30
9491,20,Madhya Pradesh,79300257,50553955,28746302,2021-11-19 23:30
9492,21,Maharashtra,105971512,70684381,35287131,2021-11-19 23:30
9493,22,Manipur,2097520,1268552,828968,2021-11-19 23:30
9494,23,Meghalaya,1906030,1142343,763687,2021-11-19 23:30
9495,24,Mizoram,1266850,723356,543494,2021-11-19 23:30
9496,25,Nagaland,1251110,722661,528449,2021-11-19 23:30
9497,26,Odisha,41368784,27175002,14193782,2021-11-19 23:30
9498,27,Puducherry,1180636,743882,436754,2021-11-19 23:30
9499,28,Punjab,23281100,16306648,6974452,2021-11-19 23:30
9500,29,Rajasthan,65177681,43012606,22165075,2021-11-19 23:30
9501,30,Sikkim,987602,522803,464799,2021-11-19 23:30
9502,31,Tamil Nadu,63965758,42983472,20982286,2021-11-19 23:30
9503,32,Telangana,35905405,24141441,11763964,2021-11-19 23:30
9504,33,Tripura,4450956,2530202,1920754,2021-11-19 23:30
9505,34,Uttar Pradesh,146740510,104678185,42062325,2021-11-19 23:30
9506,35,Uttarakhand,12105849,7535434,4570415,2021-11-19 23:30
9507,36,West Bengal,86722715,61093893,25628822,2021-11-19 23:30
9508,37,Daman and Diu,481836,277438,204398,2021-11-19 23:30
9509,1,Andaman and Nicobar Islands,533719,295819,237900,2021-11-20 23:30
9510,2,Andhra Pradesh,57124807,33928452,23196355,2021-11-20 23:30
9511,3,Arunachal Pradesh,1374222,785764,588458,2021-11-20 23:30
9512,4,Assam,31499650,20780102,10719548,2021-11-20 23:30
9513,5,Bihar,74922178,52415355,22506823,2021-11-20 23:30
9514,6,Chandigarh,1535581,934896,600685,2021-11-20 23:30
9515,7,Chhattisgarh,24300696,15681248,8619448,2021-11-20 23:30
9516,8,Dadra and Nagar Haveli,606312,392365,213947,2021-11-20 23:30
9517,9,Delhi,21822471,13537525,8284946,2021-11-20 23:30
9518,10,Goa,2271828,1275648,996180,2021-11-20 23:30
9519,11,Gujarat,77005841,45377538,31628303,2021-11-20 23:30
9520,12,Haryana,27508627,18236260,9272367,2021-11-20 23:30
9521,13,Himachal Pradesh,10339084,5776688,4562396,2021-11-20 23:30
9522,14,Jammu and Kashmir,16150156,9571664,6578492,2021-11-20 23:30
9523,15,Jharkhand,22906727,15982642,6924085,2021-11-20 23:30
9524,16,Karnataka,70226599,43685873,26540726,2021-11-20 23:30
9525,17,Kerala,41872193,25583388,16288805,2021-11-20 23:30
9526,18,Ladakh,374962,210697,164265,2021-11-20 23:30
9527,19,Lakshadweep,103782,55341,48441,2021-11-20 23:30
9528,20,Madhya Pradesh,80069175,50612271,29456904,2021-11-20 23:30
9529,21,Maharashtra,106690721,70996506,35694215,2021-11-20 23:30
9530,22,Manipur,2103325,1269832,833493,2021-11-20 23:30
9531,23,Meghalaya,1913401,1144804,768597,2021-11-20 23:30
9532,24,Mizoram,1267262,723651,543611,2021-11-20 23:30
9533,25,Nagaland,1252087,723219,528868,2021-11-20 23:30
9534,26,Odisha,41576014,27242227,14333787,2021-11-20 23:30
9535,27,Puducherry,1184190,744738,439452,2021-11-20 23:30
9536,28,Punjab,23361826,16330426,7031400,2021-11-20 23:30
9537,29,Rajasthan,65478457,43056582,22421875,2021-11-20 23:30
9538,30,Sikkim,987905,522839,465066,2021-11-20 23:30
9539,31,Tamil Nadu,64288737,43120167,21168570,2021-11-20 23:30
9540,32,Telangana,36121762,24231450,11890312,2021-11-20 23:30
9541,33,Tripura,4467306,2531368,1935938,2021-11-20 23:30
9542,34,Uttar Pradesh,147970432,105239195,42731237,2021-11-20 23:30
9543,35,Uttarakhand,12149555,7538997,4610558,2021-11-20 23:30
9544,36,West Bengal,87270275,61349312,25920963,2021-11-20 23:30
9545,37,Daman and Diu,483137,277639,205498,2021-11-20 23:30
9546,1,Andaman and Nicobar Islands,534187,295833,238354,2021-11-21 23:30
9547,2,Andhra Pradesh,57137037,33931899,23205138,2021-11-21 23:30
9548,3,Arunachal Pradesh,1374955,785995,588960,2021-11-21 23:30
9549,4,Assam,31582609,20806763,10775846,2021-11-21 23:30
9550,5,Bihar,75177806,52518221,22659585,2021-11-21 23:30
9551,6,Chandigarh,1537188,935144,602044,2021-11-21 23:30
9552,7,Chhattisgarh,24410894,15727369,8683525,2021-11-21 23:30
9553,8,Dadra and Nagar Haveli,606398,392386,214012,2021-11-21 23:30
9554,9,Delhi,21843810,13546227,8297583,2021-11-21 23:30
9555,10,Goa,2276727,1276475,1000252,2021-11-21 23:30
9556,11,Gujarat,77112357,45393151,31719206,2021-11-21 23:30
9557,12,Haryana,27565517,18256654,9308863,2021-11-21 23:30
9558,13,Himachal Pradesh,10381533,5779078,4602455,2021-11-21 23:30
9559,14,Jammu and Kashmir,16187045,9572956,6614089,2021-11-21 23:30
9560,15,Jharkhand,23039715,16037859,7001856,2021-11-21 23:30
9561,16,Karnataka,70321220,43721019,26600201,2021-11-21 23:30
9562,17,Kerala,41879766,25584045,16295721,2021-11-21 23:30
9563,18,Ladakh,375033,210707,164326,2021-11-21 23:30
9564,19,Lakshadweep,103860,55351,48509,2021-11-21 23:30
9565,20,Madhya Pradesh,80246589,50628369,29618220,2021-11-21 23:30
9566,21,Maharashtra,106874074,71095039,35779035,2021-11-21 23:30
9567,22,Manipur,2105799,1270523,835276,2021-11-21 23:30
9568,23,Meghalaya,1916062,1146316,769746,2021-11-21 23:30
9569,24,Mizoram,1267579,723958,543621,2021-11-21 23:30
9570,25,Nagaland,1256202,725579,530623,2021-11-21 23:30
9571,26,Odisha,41629148,27259808,14369340,2021-11-21 23:30
9572,27,Puducherry,1185104,744985,440119,2021-11-21 23:30
9573,28,Punjab,23383217,16337509,7045708,2021-11-21 23:30
9574,29,Rajasthan,65540994,43065654,22475340,2021-11-21 23:30
9575,30,Sikkim,987905,522839,465066,2021-11-21 23:30
9576,31,Tamil Nadu,65744845,43621438,22123407,2021-11-21 23:30
9577,32,Telangana,36164533,24254268,11910265,2021-11-21 23:30
9578,33,Tripura,4469964,2531530,1938434,2021-11-21 23:30
9579,34,Uttar Pradesh,148574595,105588852,42985743,2021-11-21 23:30
9580,35,Uttarakhand,12169142,7540389,4628753,2021-11-21 23:30
9581,36,West Bengal,87436991,61450213,25986778,2021-11-21 23:30
9582,37,Daman and Diu,483187,277650,205537,2021-11-21 23:30
9583,1,Andaman and Nicobar Islands,537064,295977,241087,2021-11-22 23:30
9584,2,Andhra Pradesh,57431514,33993208,23438306,2021-11-22 23:30
9585,3,Arunachal Pradesh,1380744,787514,593230,2021-11-22 23:30
9586,4,Assam,31801748,20849218,10952530,2021-11-22 23:30
9587,5,Bihar,75797830,52725426,23072404,2021-11-22 23:30
9588,6,Chandigarh,1541542,935869,605673,2021-11-22 23:30
9589,7,Chhattisgarh,24581763,15802888,8778875,2021-11-22 23:30
9590,8,Dadra and Nagar Haveli,608787,392942,215845,2021-11-22 23:30
9591,9,Delhi,21953354,13587475,8365879,2021-11-22 23:30
9592,10,Goa,2281330,1277203,1004127,2021-11-22 23:30
9593,11,Gujarat,77500253,45444468,32055785,2021-11-22 23:30
9594,12,Haryana,27701440,18296433,9405007,2021-11-22 23:30
9595,13,Himachal Pradesh,10456413,5784082,4672331,2021-11-22 23:30
9596,14,Jammu and Kashmir,16254529,9576555,6677974,2021-11-22 23:30
9597,15,Jharkhand,23190198,16098236,7091962,2021-11-22 23:30
9598,16,Karnataka,70555025,43789663,26765362,2021-11-22 23:30
9599,17,Kerala,41988319,25594338,16393981,2021-11-22 23:30
9600,18,Ladakh,376903,210948,165955,2021-11-22 23:30
9601,19,Lakshadweep,103963,55354,48609,2021-11-22 23:30
9602,20,Madhya Pradesh,80865660,50677255,30188405,2021-11-22 23:30
9603,21,Maharashtra,107703020,71432089,36270931,2021-11-22 23:30
9604,22,Manipur,2112310,1271904,840406,2021-11-22 23:30
9605,23,Meghalaya,1926144,1149576,776568,2021-11-22 23:30
9606,24,Mizoram,1270539,725063,545476,2021-11-22 23:30
9607,25,Nagaland,1261224,727534,533690,2021-11-22 23:30
9608,26,Odisha,41864564,27331872,14532692,2021-11-22 23:30
9609,27,Puducherry,1189753,746347,443406,2021-11-22 23:30
9610,28,Punjab,23465843,16361475,7104368,2021-11-22 23:30
9611,29,Rajasthan,65813518,43107513,22706005,2021-11-22 23:30
9612,30,Sikkim,988786,522891,465895,2021-11-22 23:30
9613,31,Tamil Nadu,66069846,43768890,22300956,2021-11-22 23:30
9614,32,Telangana,36387502,24351572,12035930,2021-11-22 23:30
9615,33,Tripura,4483508,2533205,1950303,2021-11-22 23:30
9616,34,Uttar Pradesh,150166192,106338667,43827525,2021-11-22 23:30
9617,35,Uttarakhand,12223986,7544835,4679151,2021-11-22 23:30
9618,36,West Bengal,88095934,61728618,26367316,2021-11-22 23:30
9619,37,Daman and Diu,484418,277900,206518,2021-11-22 23:30
9620,1,Andaman and Nicobar Islands,539819,296096,243723,2021-11-23 23:30
9621,2,Andhra Pradesh,57741513,34066486,23675027,2021-11-23 23:30
9622,3,Arunachal Pradesh,1383803,788329,595474,2021-11-23 23:30
9623,4,Assam,32006445,20888261,11118184,2021-11-23 23:30
9624,5,Bihar,76569105,52980332,23588773,2021-11-23 23:30
9625,6,Chandigarh,1545532,936545,608987,2021-11-23 23:30
9626,7,Chhattisgarh,24745139,15883825,8861314,2021-11-23 23:30
9627,8,Dadra and Nagar Haveli,611310,393505,217805,2021-11-23 23:30
9628,9,Delhi,22064755,13631115,8433640,2021-11-23 23:30
9629,10,Goa,2285499,1277852,1007647,2021-11-23 23:30
9630,11,Gujarat,78015027,45502428,32512599,2021-11-23 23:30
9631,12,Haryana,27856727,18343003,9513724,2021-11-23 23:30
9632,13,Himachal Pradesh,10544965,5790042,4754923,2021-11-23 23:30
9633,14,Jammu and Kashmir,16329338,9580033,6749305,2021-11-23 23:30
9634,15,Jharkhand,23360546,16164786,7195760,2021-11-23 23:30
9635,16,Karnataka,70913279,43868680,27044599,2021-11-23 23:30
9636,17,Kerala,42133999,25606495,16527504,2021-11-23 23:30
9637,18,Ladakh,378368,211126,167242,2021-11-23 23:30
9638,19,Lakshadweep,104047,55359,48688,2021-11-23 23:30
9639,20,Madhya Pradesh,81314108,50716867,30597241,2021-11-23 23:30
9640,21,Maharashtra,108466942,71753953,36712989,2021-11-23 23:30
9641,22,Manipur,2117681,1272948,844733,2021-11-23 23:30
9642,23,Meghalaya,1936240,1152975,783265,2021-11-23 23:30
9643,24,Mizoram,1273672,726071,547601,2021-11-23 23:30
9644,25,Nagaland,1265115,729006,536109,2021-11-23 23:30
9645,26,Odisha,42106115,27409944,14696171,2021-11-23 23:30
9646,27,Puducherry,1194646,747878,446768,2021-11-23 23:30
9647,28,Punjab,23564459,16390537,7173922,2021-11-23 23:30
9648,29,Rajasthan,66111867,43152508,22959359,2021-11-23 23:30
9649,30,Sikkim,989288,522914,466374,2021-11-23 23:30
9650,31,Tamil Nadu,66435534,43924986,22510548,2021-11-23 23:30
9651,32,Telangana,36627436,24457375,12170061,2021-11-23 23:30
9652,33,Tripura,4497630,2535621,1962009,2021-11-23 23:30
9653,34,Uttar Pradesh,151901560,107151053,44750507,2021-11-23 23:30
9654,35,Uttarakhand,12289258,7550047,4739211,2021-11-23 23:30
9655,36,West Bengal,88841454,61986273,26855181,2021-11-23 23:30
9656,37,Daman and Diu,485668,278162,207506,2021-11-23 23:30
9657,1,Andaman and Nicobar Islands,542473,296217,246256,2021-11-24 23:30
9658,2,Andhra Pradesh,58025701,34141892,23883809,2021-11-24 23:30
9659,3,Arunachal Pradesh,1388145,789388,598757,2021-11-24 23:30
9660,4,Assam,32153148,20919649,11233499,2021-11-24 23:30
9661,5,Bihar,77223626,53208146,24015480,2021-11-24 23:30
9662,6,Chandigarh,1549218,937224,611994,2021-11-24 23:30
9663,7,Chhattisgarh,24934283,15977815,8956468,2021-11-24 23:30
9664,8,Dadra and Nagar Haveli,613080,393863,219217,2021-11-24 23:30
9665,9,Delhi,22157764,13667725,8490039,2021-11-24 23:30
9666,10,Goa,2289191,1278480,1010711,2021-11-24 23:30
9667,11,Gujarat,78465087,45551685,32913402,2021-11-24 23:30
9668,12,Haryana,27989022,18384740,9604282,2021-11-24 23:30
9669,13,Himachal Pradesh,10634294,5796237,4838057,2021-11-24 23:30
9670,14,Jammu and Kashmir,16397063,9583340,6813723,2021-11-24 23:30
9671,15,Jharkhand,23535091,16232665,7302426,2021-11-24 23:30
9672,16,Karnataka,71786138,44031537,27754601,2021-11-24 23:30
9673,17,Kerala,42178783,25611152,16567631,2021-11-24 23:30
9674,18,Ladakh,379211,211275,167936,2021-11-24 23:30
9675,19,Lakshadweep,104124,55369,48755,2021-11-24 23:30
9676,20,Madhya Pradesh,83252268,50852647,32399621,2021-11-24 23:30
9677,21,Maharashtra,109291581,72095831,37195750,2021-11-24 23:30
9678,22,Manipur,2122508,1273909,848599,2021-11-24 23:30
9679,23,Meghalaya,1943949,1155641,788308,2021-11-24 23:30
9680,24,Mizoram,1276404,727062,549342,2021-11-24 23:30
9681,25,Nagaland,1268701,730347,538354,2021-11-24 23:30
9682,26,Odisha,42327999,27482019,14845980,2021-11-24 23:30
9683,27,Puducherry,1201632,750689,450943,2021-11-24 23:30
9684,28,Punjab,23638077,16411372,7226705,2021-11-24 23:30
9685,29,Rajasthan,66401492,43197274,23204218,2021-11-24 23:30
9686,30,Sikkim,989841,522961,466880,2021-11-24 23:30
9687,31,Tamil Nadu,66789727,44087671,22702056,2021-11-24 23:30
9688,32,Telangana,36807350,24539705,12267645,2021-11-24 23:30
9689,33,Tripura,4509680,2537700,1971980,2021-11-24 23:30
9690,34,Uttar Pradesh,153477254,107927373,45549881,2021-11-24 23:30
9691,35,Uttarakhand,12343936,7554962,4788974,2021-11-24 23:30
9692,36,West Bengal,89509353,62213352,27296001,2021-11-24 23:30
9693,37,Daman and Diu,486792,278356,208436,2021-11-24 23:30
9694,1,Andaman and Nicobar Islands,544653,296305,248348,2021-11-25 23:30
9695,2,Andhra Pradesh,58338068,34240668,24097400,2021-11-25 23:30
9696,3,Arunachal Pradesh,1392276,790719,601557,2021-11-25 23:30
9697,4,Assam,32348771,20957790,11390981,2021-11-25 23:30
9698,5,Bihar,78014636,53471639,24542997,2021-11-25 23:30
9699,6,Chandigarh,1552791,937827,614964,2021-11-25 23:30
9700,7,Chhattisgarh,25101711,16060837,9040874,2021-11-25 23:30
9701,8,Dadra and Nagar Haveli,614778,394176,220602,2021-11-25 23:30
9702,9,Delhi,22260471,13708314,8552157,2021-11-25 23:30
9703,10,Goa,2292774,1279025,1013749,2021-11-25 23:30
9704,11,Gujarat,79000441,45605968,33394473,2021-11-25 23:30
9705,12,Haryana,28139536,18429003,9710533,2021-11-25 23:30
9706,13,Himachal Pradesh,10715249,5802170,4913079,2021-11-25 23:30
9707,14,Jammu and Kashmir,16449002,9586565,6862437,2021-11-25 23:30
9708,15,Jharkhand,23693606,16297200,7396406,2021-11-25 23:30
9709,16,Karnataka,72097081,44111943,27985138,2021-11-25 23:30
9710,17,Kerala,42269598,25619174,16650424,2021-11-25 23:30
9711,18,Ladakh,380166,211396,168770,2021-11-25 23:30
9712,19,Lakshadweep,104242,55379,48863,2021-11-25 23:30
9713,20,Madhya Pradesh,84094587,50920392,33174195,2021-11-25 23:30
9714,21,Maharashtra,110086653,72427443,37659210,2021-11-25 23:30
9715,22,Manipur,2127163,1274844,852319,2021-11-25 23:30
9716,23,Meghalaya,1953143,1158537,794606,2021-11-25 23:30
9717,24,Mizoram,1278685,727696,550989,2021-11-25 23:30
9718,25,Nagaland,1271688,731491,540197,2021-11-25 23:30
9719,26,Odisha,42572597,27553018,15019579,2021-11-25 23:30
9720,27,Puducherry,1209242,754079,455163,2021-11-25 23:30
9721,28,Punjab,23745663,16441547,7304116,2021-11-25 23:30
9722,29,Rajasthan,66679103,43243063,23436040,2021-11-25 23:30
9723,30,Sikkim,990558,523021,467537,2021-11-25 23:30
9724,31,Tamil Nadu,67773587,44453286,23320301,2021-11-25 23:30
9725,32,Telangana,37019134,24634220,12384914,2021-11-25 23:30
9726,33,Tripura,4518620,2539788,1978832,2021-11-25 23:30
9727,34,Uttar Pradesh,155271539,108766774,46504765,2021-11-25 23:30
9728,35,Uttarakhand,12400833,7559943,4840890,2021-11-25 23:30
9729,36,West Bengal,90052635,62387382,27665253,2021-11-25 23:30
9730,37,Daman and Diu,487920,278494,209426,2021-11-25 23:30
9731,1,Andaman and Nicobar Islands,546984,296410,250574,2021-11-26 23:30
9732,2,Andhra Pradesh,58685528,34363915,24321613,2021-11-26 23:30
9733,3,Arunachal Pradesh,1395820,791617,604203,2021-11-26 23:30
9734,4,Assam,32523103,20990895,11532208,2021-11-26 23:30
9735,5,Bihar,78670636,53686888,24983748,2021-11-26 23:30
9736,6,Chandigarh,1556506,938486,618020,2021-11-26 23:30
9737,7,Chhattisgarh,25236861,16127827,9109034,2021-11-26 23:30
9738,8,Dadra and Nagar Haveli,616250,394441,221809,2021-11-26 23:30
9739,9,Delhi,22347107,13740798,8606309,2021-11-26 23:30
9740,10,Goa,2296419,1279609,1016810,2021-11-26 23:30
9741,11,Gujarat,79503840,45659783,33844057,2021-11-26 23:30
9742,12,Haryana,28275506,18470082,9805424,2021-11-26 23:30
9743,13,Himachal Pradesh,10788152,5807882,4980270,2021-11-26 23:30
9744,14,Jammu and Kashmir,16489504,9590114,6899390,2021-11-26 23:30
9745,15,Jharkhand,23850417,16357068,7493349,2021-11-26 23:30
9746,16,Karnataka,72542783,44215556,28327227,2021-11-26 23:30
9747,17,Kerala,42428395,25630785,16797610,2021-11-26 23:30
9748,18,Ladakh,381222,211525,169697,2021-11-26 23:30
9749,19,Lakshadweep,104374,55386,48988,2021-11-26 23:30
9750,20,Madhya Pradesh,84584603,50962249,33622354,2021-11-26 23:30
9751,21,Maharashtra,110849813,72750398,38099415,2021-11-26 23:30
9752,22,Manipur,2132614,1276059,856555,2021-11-26 23:30
9753,23,Meghalaya,1960434,1160793,799641,2021-11-26 23:30
9754,24,Mizoram,1281963,728843,553120,2021-11-26 23:30
9755,25,Nagaland,1275023,732766,542257,2021-11-26 23:30
9756,26,Odisha,42796052,27617878,15178174,2021-11-26 23:30
9757,27,Puducherry,1215780,756824,458956,2021-11-26 23:30
9758,28,Punjab,23836445,16467638,7368807,2021-11-26 23:30
9759,29,Rajasthan,66957775,43288285,23669490,2021-11-26 23:30
9760,30,Sikkim,991476,523086,468390,2021-11-26 23:30
9761,31,Tamil Nadu,68160640,44615139,23545501,2021-11-26 23:30
9762,32,Telangana,37222866,24724191,12498675,2021-11-26 23:30
9763,33,Tripura,4530635,2542351,1988284,2021-11-26 23:30
9764,34,Uttar Pradesh,156999722,109581858,47417864,2021-11-26 23:30
9765,35,Uttarakhand,12461113,7565283,4895830,2021-11-26 23:30
9766,36,West Bengal,90744906,62606581,28138325,2021-11-26 23:30
9767,37,Daman and Diu,488955,278668,210287,2021-11-26 23:30
9768,1,Andaman and Nicobar Islands,549032,296538,252494,2021-11-27 23:30
9769,2,Andhra Pradesh,58990319,34479687,24510632,2021-11-27 23:30
9770,3,Arunachal Pradesh,1399053,792501,606552,2021-11-27 23:30
9771,4,Assam,32692443,21024382,11668061,2021-11-27 23:30
9772,5,Bihar,79838061,54019476,25818585,2021-11-27 23:30
9773,6,Chandigarh,1561653,939297,622356,2021-11-27 23:30
9774,7,Chhattisgarh,25534758,16303131,9231627,2021-11-27 23:30
9775,8,Dadra and Nagar Haveli,617753,394706,223047,2021-11-27 23:30
9776,9,Delhi,22471172,13783246,8687926,2021-11-27 23:30
9777,10,Goa,2301262,1280384,1020878,2021-11-27 23:30
9778,11,Gujarat,79906949,45702152,34204797,2021-11-27 23:30
9779,12,Haryana,28400358,18506099,9894259,2021-11-27 23:30
9780,13,Himachal Pradesh,10848543,5812897,5035646,2021-11-27 23:30
9781,14,Jammu and Kashmir,16525154,9593142,6932012,2021-11-27 23:30
9782,15,Jharkhand,23998150,16417589,7580561,2021-11-27 23:30
9783,16,Karnataka,73028459,44354147,28674312,2021-11-27 23:30
9784,17,Kerala,42674395,25650538,17023857,2021-11-27 23:30
9785,18,Ladakh,382014,211646,170368,2021-11-27 23:30
9786,19,Lakshadweep,104486,55397,49089,2021-11-27 23:30
9787,20,Madhya Pradesh,85362120,51022481,34339639,2021-11-27 23:30
9788,21,Maharashtra,111688539,73088421,38600118,2021-11-27 23:30
9789,22,Manipur,2138886,1277529,861357,2021-11-27 23:30
9790,23,Meghalaya,1964687,1162110,802577,2021-11-27 23:30
9791,24,Mizoram,1283941,730018,553923,2021-11-27 23:30
9792,25,Nagaland,1276244,733376,542868,2021-11-27 23:30
9793,26,Odisha,43006258,27680716,15325542,2021-11-27 23:30
9794,27,Puducherry,1224324,760200,464124,2021-11-27 23:30
9795,28,Punjab,23934206,16493654,7440552,2021-11-27 23:30
9796,29,Rajasthan,67440722,43358294,24082428,2021-11-27 23:30
9797,30,Sikkim,991752,523116,468636,2021-11-27 23:30
9798,31,Tamil Nadu,68472021,44747363,23724658,2021-11-27 23:30
9799,32,Telangana,37425979,24807309,12618670,2021-11-27 23:30
9800,33,Tripura,4547079,2545663,2001416,2021-11-27 23:30
9801,34,Uttar Pradesh,158616022,110370709,48245313,2021-11-27 23:30
9802,35,Uttarakhand,12519269,7570585,4948684,2021-11-27 23:30
9803,36,West Bengal,91306099,62805692,28500407,2021-11-27 23:30
9804,37,Daman and Diu,490217,278857,211360,2021-11-27 23:30
9805,1,Andaman and Nicobar Islands,549324,296571,252753,2021-11-28 23:30
9806,2,Andhra Pradesh,59135468,34555954,24579514,2021-11-28 23:30
9807,3,Arunachal Pradesh,1400015,792816,607199,2021-11-28 23:30
9808,4,Assam,32749953,21039317,11710636,2021-11-28 23:30
9809,5,Bihar,80271583,54139388,26132195,2021-11-28 23:30
9810,6,Chandigarh,1563660,939640,624020,2021-11-28 23:30
9811,7,Chhattisgarh,25623545,16345460,9278085,2021-11-28 23:30
9812,8,Dadra and Nagar Haveli,617845,394739,223106,2021-11-28 23:30
9813,9,Delhi,22499281,13794257,8705024,2021-11-28 23:30
9814,10,Goa,2306625,1281406,1025219,2021-11-28 23:30
9815,11,Gujarat,80034232,45717439,34316793,2021-11-28 23:30
9816,12,Haryana,28456135,18522959,9933176,2021-11-28 23:30
9817,13,Himachal Pradesh,10887486,5815963,5071523,2021-11-28 23:30
9818,14,Jammu and Kashmir,16538388,9593986,6944402,2021-11-28 23:30
9819,15,Jharkhand,24141320,16472082,7669238,2021-11-28 23:30
9820,16,Karnataka,73301079,44458741,28842338,2021-11-28 23:30
9821,17,Kerala,42687603,25651685,17035918,2021-11-28 23:30
9822,18,Ladakh,382101,211660,170441,2021-11-28 23:30
9823,19,Lakshadweep,104491,55397,49094,2021-11-28 23:30
9824,20,Madhya Pradesh,85575271,51036158,34539113,2021-11-28 23:30
9825,21,Maharashtra,112010765,73254410,38756355,2021-11-28 23:30
9826,22,Manipur,2143137,1279041,864096,2021-11-28 23:30
9827,23,Meghalaya,1965057,1162285,802772,2021-11-28 23:30
9828,24,Mizoram,1284196,730211,553985,2021-11-28 23:30
9829,25,Nagaland,1281047,736371,544676,2021-11-28 23:30
9830,26,Odisha,43084748,27716069,15368679,2021-11-28 23:30
9831,27,Puducherry,1226554,761274,465280,2021-11-28 23:30
9832,28,Punjab,23957706,16500949,7456757,2021-11-28 23:30
9833,29,Rajasthan,67518410,43369760,24148650,2021-11-28 23:30
9834,30,Sikkim,991752,523116,468636,2021-11-28 23:30
9835,31,Tamil Nadu,69848105,45207361,24640744,2021-11-28 23:30
9836,32,Telangana,37459050,24824173,12634877,2021-11-28 23:30
9837,33,Tripura,4550212,2547337,2002875,2021-11-28 23:30
9838,34,Uttar Pradesh,159537825,110874921,48662904,2021-11-28 23:30
9839,35,Uttarakhand,12543278,7572788,4970490,2021-11-28 23:30
9840,36,West Bengal,91534365,62914564,28619801,2021-11-28 23:30
9841,37,Daman and Diu,490219,278857,211362,2021-11-28 23:30
9842,1,Andaman and Nicobar Islands,551563,296743,254820,2021-11-29 23:30
9843,2,Andhra Pradesh,59430952,34685194,24745758,2021-11-29 23:30
9844,3,Arunachal Pradesh,1404066,793938,610128,2021-11-29 23:30
9845,4,Assam,32961655,21087224,11874431,2021-11-29 23:30
9846,5,Bihar,80869489,54289855,26579634,2021-11-29 23:30
9847,6,Chandigarh,1568675,940604,628071,2021-11-29 23:30
9848,7,Chhattisgarh,25767099,16401237,9365862,2021-11-29 23:30
9849,8,Dadra and Nagar Haveli,619612,395053,224559,2021-11-29 23:30
9850,9,Delhi,22632081,13842406,8789675,2021-11-29 23:30
9851,10,Goa,2311036,1282226,1028810,2021-11-29 23:30
9852,11,Gujarat,80558881,45773290,34785591,2021-11-29 23:30
9853,12,Haryana,28589189,18560280,10028909,2021-11-29 23:30
9854,13,Himachal Pradesh,10940061,5820639,5119422,2021-11-29 23:30
9855,14,Jammu and Kashmir,16582594,9597744,6984850,2021-11-29 23:30
9856,15,Jharkhand,24299958,16530474,7769484,2021-11-29 23:30
9857,16,Karnataka,73862078,44633864,29228214,2021-11-29 23:30
9858,17,Kerala,42874210,25670723,17203487,2021-11-29 23:30
9859,18,Ladakh,382780,211855,170925,2021-11-29 23:30
9860,19,Lakshadweep,104589,55398,49191,2021-11-29 23:30
9861,20,Madhya Pradesh,86112047,51076555,35035492,2021-11-29 23:30
9862,21,Maharashtra,113114059,73732054,39382005,2021-11-29 23:30
9863,22,Manipur,2150955,1280981,869974,2021-11-29 23:30
9864,23,Meghalaya,1971840,1164508,807332,2021-11-29 23:30
9865,24,Mizoram,1288176,731728,556448,2021-11-29 23:30
9866,25,Nagaland,1284859,737951,546908,2021-11-29 23:30
9867,26,Odisha,43345130,27785811,15559319,2021-11-29 23:30
9868,27,Puducherry,1233544,764178,469366,2021-11-29 23:30
9869,28,Punjab,24051002,16526453,7524549,2021-11-29 23:30
9870,29,Rajasthan,67930763,43434754,24496009,2021-11-29 23:30
9871,30,Sikkim,992632,523190,469442,2021-11-29 23:30
9872,31,Tamil Nadu,70110097,45313763,24796334,2021-11-29 23:30
9873,32,Telangana,37659346,24898678,12760668,2021-11-29 23:30
9874,33,Tripura,4565341,2550643,2014698,2021-11-29 23:30
9875,34,Uttar Pradesh,161114736,111602509,49512227,2021-11-29 23:30
9876,35,Uttarakhand,12610249,7579400,5030849,2021-11-29 23:30
9877,36,West Bengal,92184199,63106737,29077462,2021-11-29 23:30
9878,37,Daman and Diu,491782,279137,212645,2021-11-29 23:30
9879,1,Andaman and Nicobar Islands,553559,296844,256715,2021-11-30 23:30
9880,2,Andhra Pradesh,59714908,34817916,24896992,2021-11-30 23:30
9881,3,Arunachal Pradesh,1407241,794862,612379,2021-11-30 23:30
9882,4,Assam,33181363,21147890,12033473,2021-11-30 23:30
9883,5,Bihar,81837895,54512367,27325528,2021-11-30 23:30
9884,6,Chandigarh,1573600,941595,632005,2021-11-30 23:30
9885,7,Chhattisgarh,25915580,16462160,9453420,2021-11-30 23:30
9886,8,Dadra and Nagar Haveli,621009,395253,225756,2021-11-30 23:30
9887,9,Delhi,22756920,13890145,8866775,2021-11-30 23:30
9888,10,Goa,2315618,1283128,1032490,2021-11-30 23:30
9889,11,Gujarat,81096320,45827265,35269055,2021-11-30 23:30
9890,12,Haryana,28719749,18598043,10121706,2021-11-30 23:30
9891,13,Himachal Pradesh,10995471,5825320,5170151,2021-11-30 23:30
9892,14,Jammu and Kashmir,16641016,9601811,7039205,2021-11-30 23:30
9893,15,Jharkhand,24473784,16595986,7877798,2021-11-30 23:30
9894,16,Karnataka,74447105,44815478,29631627,2021-11-30 23:30
9895,17,Kerala,43055295,25688906,17366389,2021-11-30 23:30
9896,18,Ladakh,383227,211980,171247,2021-11-30 23:30
9897,19,Lakshadweep,104815,55420,49395,2021-11-30 23:30
9898,20,Madhya Pradesh,86487701,51111112,35376589,2021-11-30 23:30
9899,21,Maharashtra,114327916,74308398,40019518,2021-11-30 23:30
9900,22,Manipur,2159864,1282981,876883,2021-11-30 23:30
9901,23,Meghalaya,1978444,1166770,811674,2021-11-30 23:30
9902,24,Mizoram,1292854,733509,559345,2021-11-30 23:30
9903,25,Nagaland,1287880,739104,548776,2021-11-30 23:30
9904,26,Odisha,43611314,27862454,15748860,2021-11-30 23:30
9905,27,Puducherry,1241685,767369,474316,2021-11-30 23:30
9906,28,Punjab,24154500,16554978,7599522,2021-11-30 23:30
9907,29,Rajasthan,68405654,43517960,24887694,2021-11-30 23:30
9908,30,Sikkim,993396,523263,470133,2021-11-30 23:30
9909,31,Tamil Nadu,70423590,45433240,24990350,2021-11-30 23:30
9910,32,Telangana,37828838,24964748,12864090,2021-11-30 23:30
9911,33,Tripura,4577402,2553203,2024199,2021-11-30 23:30
9912,34,Uttar Pradesh,162698017,112334252,50363765,2021-11-30 23:30
9913,35,Uttarakhand,12683516,7587322,5096194,2021-11-30 23:30
9914,36,West Bengal,92773093,63281167,29491926,2021-11-30 23:30
9915,37,Daman and Diu,492808,279374,213434,2021-11-30 23:30
9916,1,Andaman and Nicobar Islands,555434,296963,258471,2021-12-01 23:30
9917,2,Andhra Pradesh,60022958,34990850,25032108,2021-12-01 23:30
9918,3,Arunachal Pradesh,1407983,795128,612855,2021-12-01 23:30
9919,4,Assam,33367816,21208386,12159430,2021-12-01 23:30
9920,5,Bihar,82422830,54635325,27787505,2021-12-01 23:30
9921,6,Chandigarh,1578337,942625,635712,2021-12-01 23:30
9922,7,Chhattisgarh,26035108,16509056,9526052,2021-12-01 23:30
9923,8,Dadra and Nagar Haveli,622436,395481,226955,2021-12-01 23:30
9924,9,Delhi,22856744,13927164,8929580,2021-12-01 23:30
9925,10,Goa,2319616,1283959,1035657,2021-12-01 23:30
9926,11,Gujarat,81523164,45867820,35655344,2021-12-01 23:30
9927,12,Haryana,28825041,18625304,10199737,2021-12-01 23:30
9928,13,Himachal Pradesh,11038403,5828587,5209816,2021-12-01 23:30
9929,14,Jammu and Kashmir,16698957,9605609,7093348,2021-12-01 23:30
9930,15,Jharkhand,24629747,16653114,7976633,2021-12-01 23:30
9931,16,Karnataka,75444503,45079481,30365022,2021-12-01 23:30
9932,17,Kerala,43127813,25697638,17430175,2021-12-01 23:30
9933,18,Ladakh,383563,212072,171491,2021-12-01 23:30
9934,19,Lakshadweep,104968,55432,49536,2021-12-01 23:30
9935,20,Madhya Pradesh,88139196,51219723,36919473,2021-12-01 23:30
9936,21,Maharashtra,115233772,74687979,40545793,2021-12-01 23:30
9937,22,Manipur,2168204,1284657,883547,2021-12-01 23:30
9938,23,Meghalaya,1983652,1168603,815049,2021-12-01 23:30
9939,24,Mizoram,1295897,734442,561455,2021-12-01 23:30
9940,25,Nagaland,1289392,739787,549605,2021-12-01 23:30
9941,26,Odisha,43837084,27914369,15922715,2021-12-01 23:30
9942,27,Puducherry,1248503,770388,478115,2021-12-01 23:30
9943,28,Punjab,24226632,16573020,7653612,2021-12-01 23:30
9944,29,Rajasthan,68846196,43599216,25246980,2021-12-01 23:30
9945,30,Sikkim,993750,523297,470453,2021-12-01 23:30
9946,31,Tamil Nadu,70726739,45550375,25176364,2021-12-01 23:30
9947,32,Telangana,38016635,25055238,12961397,2021-12-01 23:30
9948,33,Tripura,4584435,2554489,2029946,2021-12-01 23:30
9949,34,Uttar Pradesh,163792118,112828916,50963202,2021-12-01 23:30
9950,35,Uttarakhand,12741378,7594083,5147295,2021-12-01 23:30
9951,36,West Bengal,93107406,63368448,29738958,2021-12-01 23:30
9952,37,Daman and Diu,493568,279521,214047,2021-12-01 23:30
9953,1,Andaman and Nicobar Islands,557403,297052,260351,2021-12-02 23:30
9954,2,Andhra Pradesh,60356174,35183015,25173159,2021-12-02 23:30
9955,3,Arunachal Pradesh,1410758,795857,614901,2021-12-02 23:30
9956,4,Assam,33607654,21286259,12321395,2021-12-02 23:30
9957,5,Bihar,83096729,54778033,28318696,2021-12-02 23:30
9958,6,Chandigarh,1583128,943618,639510,2021-12-02 23:30
9959,7,Chhattisgarh,26221548,16568450,9653098,2021-12-02 23:30
9960,8,Dadra and Nagar Haveli,623714,395738,227976,2021-12-02 23:30
9961,9,Delhi,22963808,13965888,8997920,2021-12-02 23:30
9962,10,Goa,2323528,1284838,1038690,2021-12-02 23:30
9963,11,Gujarat,81940528,45903396,36037132,2021-12-02 23:30
9964,12,Haryana,28951502,18657144,10294358,2021-12-02 23:30
9965,13,Himachal Pradesh,11096127,5831561,5264566,2021-12-02 23:30
9966,14,Jammu and Kashmir,16767034,9609238,7157796,2021-12-02 23:30
9967,15,Jharkhand,24779634,16709960,8069674,2021-12-02 23:30
9968,16,Karnataka,75936606,45245878,30690728,2021-12-02 23:30
9969,17,Kerala,43417445,25730130,17687315,2021-12-02 23:30
9970,18,Ladakh,383980,212205,171775,2021-12-02 23:30
9971,19,Lakshadweep,105099,55441,49658,2021-12-02 23:30
9972,20,Madhya Pradesh,88794881,51266179,37528702,2021-12-02 23:30
9973,21,Maharashtra,116218434,75048890,41169544,2021-12-02 23:30
9974,22,Manipur,2175857,1286268,889589,2021-12-02 23:30
9975,23,Meghalaya,1989942,1170779,819163,2021-12-02 23:30
9976,24,Mizoram,1298272,734921,563351,2021-12-02 23:30
9977,25,Nagaland,1291580,740626,550954,2021-12-02 23:30
9978,26,Odisha,44064875,27966239,16098636,2021-12-02 23:30
9979,27,Puducherry,1255641,773604,482037,2021-12-02 23:30
9980,28,Punjab,24329664,16597774,7731890,2021-12-02 23:30
9981,29,Rajasthan,69222240,43673976,25548264,2021-12-02 23:30
9982,30,Sikkim,994449,523346,471103,2021-12-02 23:30
9983,31,Tamil Nadu,71064022,45686172,25377850,2021-12-02 23:30
9984,32,Telangana,38247408,25165533,13081875,2021-12-02 23:30
9985,33,Tripura,4592759,2555677,2037082,2021-12-02 23:30
9986,34,Uttar Pradesh,164971859,113337854,51634005,2021-12-02 23:30
9987,35,Uttarakhand,12803434,7601344,5202090,2021-12-02 23:30
9988,36,West Bengal,93616138,63481198,30134940,2021-12-02 23:30
9989,37,Daman and Diu,494328,279703,214625,2021-12-02 23:30
9990,1,Andaman and Nicobar Islands,559347,297145,262202,2021-12-03 23:30
9991,2,Andhra Pradesh,60729083,35408952,25320131,2021-12-03 23:30
9992,3,Arunachal Pradesh,1413038,796483,616555,2021-12-03 23:30
9993,4,Assam,33848126,21364387,12483739,2021-12-03 23:30
9994,5,Bihar,83690164,54896993,28793171,2021-12-03 23:30
9995,6,Chandigarh,1588096,944710,643386,2021-12-03 23:30
9996,7,Chhattisgarh,26380439,16617555,9762884,2021-12-03 23:30
9997,8,Dadra and Nagar Haveli,625441,396040,229401,2021-12-03 23:30
9998,9,Delhi,23068428,14005365,9063063,2021-12-03 23:30
9999,10,Goa,2326944,1285559,1041385,2021-12-03 23:30
10000,11,Gujarat,82320669,45944986,36375683,2021-12-03 23:30
10001,12,Haryana,29092351,18691724,10400627,2021-12-03 23:30
10002,13,Himachal Pradesh,11167429,5834766,5332663,2021-12-03 23:30
10003,14,Jammu and Kashmir,16832100,9613144,7218956,2021-12-03 23:30
10004,15,Jharkhand,24942351,16768958,8173393,2021-12-03 23:30
10005,16,Karnataka,76495895,45417165,31078730,2021-12-03 23:30
10006,17,Kerala,43641448,25755370,17886078,2021-12-03 23:30
10007,18,Ladakh,384272,212275,171997,2021-12-03 23:30
10008,19,Lakshadweep,105245,55454,49791,2021-12-03 23:30
10009,20,Madhya Pradesh,89234873,51300849,37934024,2021-12-03 23:30
10010,21,Maharashtra,117241115,75433820,41807295,2021-12-03 23:30
10011,22,Manipur,2184964,1288350,896614,2021-12-03 23:30
10012,23,Meghalaya,1994755,1172300,822455,2021-12-03 23:30
10013,24,Mizoram,1300742,736488,564254,2021-12-03 23:30
10014,25,Nagaland,1294607,741817,552790,2021-12-03 23:30
10015,26,Odisha,44299694,28022835,16276859,2021-12-03 23:30
10016,27,Puducherry,1262480,776643,485837,2021-12-03 23:30
10017,28,Punjab,24428107,16621648,7806459,2021-12-03 23:30
10018,29,Rajasthan,69713790,43771175,25942615,2021-12-03 23:30
10019,30,Sikkim,995272,523437,471835,2021-12-03 23:30
10020,31,Tamil Nadu,71400705,45830710,25569995,2021-12-03 23:30
10021,32,Telangana,38523281,25299053,13224228,2021-12-03 23:30
10022,33,Tripura,4600508,2556916,2043592,2021-12-03 23:30
10023,34,Uttar Pradesh,166180707,113851334,52329373,2021-12-03 23:30
10024,35,Uttarakhand,12866164,7609358,5256806,2021-12-03 23:30
10025,36,West Bengal,94171776,63598926,30572850,2021-12-03 23:30
10026,37,Daman and Diu,495712,279951,215761,2021-12-03 23:30
10027,1,Andaman and Nicobar Islands,561084,297303,263781,2021-12-04 23:30
10028,2,Andhra Pradesh,61148742,35663596,25485146,2021-12-04 23:30
10029,3,Arunachal Pradesh,1414992,796959,618033,2021-12-04 23:30
10030,4,Assam,34071903,21440730,12631173,2021-12-04 23:30
10031,5,Bihar,85266616,55178657,30087959,2021-12-04 23:30
10032,6,Chandigarh,1594958,946170,648788,2021-12-04 23:30
10033,7,Chhattisgarh,26657766,16724128,9933638,2021-12-04 23:30
10034,8,Dadra and Nagar Haveli,627097,396331,230766,2021-12-04 23:30
10035,9,Delhi,23233734,14067990,9165744,2021-12-04 23:30
10036,10,Goa,2331883,1286728,1045155,2021-12-04 23:30
10037,11,Gujarat,82726822,45993901,36732921,2021-12-04 23:30
10038,12,Haryana,29232253,18725492,10506761,2021-12-04 23:30
10039,13,Himachal Pradesh,11227173,5837925,5389248,2021-12-04 23:30
10040,14,Jammu and Kashmir,16886515,9616806,7269709,2021-12-04 23:30
10041,15,Jharkhand,25079537,16820570,8258967,2021-12-04 23:30
10042,16,Karnataka,77023872,45578451,31445421,2021-12-04 23:30
10043,17,Kerala,43834366,25777945,18056421,2021-12-04 23:30
10044,18,Ladakh,384795,212359,172436,2021-12-04 23:30
10045,19,Lakshadweep,105404,55463,49941,2021-12-04 23:30
10046,20,Madhya Pradesh,89957482,51356031,38601451,2021-12-04 23:30
10047,21,Maharashtra,118264823,75812508,42452315,2021-12-04 23:30
10048,22,Manipur,2192443,1290216,902227,2021-12-04 23:30
10049,23,Meghalaya,1997250,1173179,824071,2021-12-04 23:30
10050,24,Mizoram,1301381,736891,564490,2021-12-04 23:30
10051,25,Nagaland,1295189,742154,553035,2021-12-04 23:30
10052,26,Odisha,44471483,28064845,16406638,2021-12-04 23:30
10053,27,Puducherry,1270936,780564,490372,2021-12-04 23:30
10054,28,Punjab,24539586,16648639,7890947,2021-12-04 23:30
10055,29,Rajasthan,70843630,43967258,26876372,2021-12-04 23:30
10056,30,Sikkim,995610,523497,472113,2021-12-04 23:30
10057,31,Tamil Nadu,72965290,46355042,26610248,2021-12-04 23:30
10058,32,Telangana,38847307,25466946,13380361,2021-12-04 23:30
10059,33,Tripura,4606285,2557786,2048499,2021-12-04 23:30
10060,34,Uttar Pradesh,167306906,114319011,52987895,2021-12-04 23:30
10061,35,Uttarakhand,12938178,7618611,5319567,2021-12-04 23:30
10062,36,West Bengal,94534488,63671249,30863239,2021-12-04 23:30
10063,37,Daman and Diu,497431,280402,217029,2021-12-04 23:30
10064,1,Andaman and Nicobar Islands,561598,297328,264270,2021-12-05 23:30
10065,2,Andhra Pradesh,61479344,35892527,25586817,2021-12-05 23:30
10066,3,Arunachal Pradesh,1415186,797015,618171,2021-12-05 23:30
10067,4,Assam,34185093,21485439,12699654,2021-12-05 23:30
10068,5,Bihar,85710116,55265539,30444577,2021-12-05 23:30
10069,6,Chandigarh,1597911,946805,651106,2021-12-05 23:30
10070,7,Chhattisgarh,26758495,16766880,9991615,2021-12-05 23:30
10071,8,Dadra and Nagar Haveli,627221,396371,230850,2021-12-05 23:30
10072,9,Delhi,23279025,14087345,9191680,2021-12-05 23:30
10073,10,Goa,2331885,1286729,1045156,2021-12-05 23:30
10074,11,Gujarat,82842882,46010679,36832203,2021-12-05 23:30
10075,12,Haryana,29288734,18740239,10548495,2021-12-05 23:30
10076,13,Himachal Pradesh,11229262,5838123,5391139,2021-12-05 23:30
10077,14,Jammu and Kashmir,16920111,9617655,7302456,2021-12-05 23:30
10078,15,Jharkhand,25219412,16868540,8350872,2021-12-05 23:30
10079,16,Karnataka,77192425,45638036,31554389,2021-12-05 23:30
10080,17,Kerala,43843393,25779370,18064023,2021-12-05 23:30
10081,18,Ladakh,384795,212359,172436,2021-12-05 23:30
10082,19,Lakshadweep,105511,55469,50042,2021-12-05 23:30
10083,20,Madhya Pradesh,90151542,51369073,38782469,2021-12-05 23:30
10084,21,Maharashtra,118444773,75889470,42555303,2021-12-05 23:30
10085,22,Manipur,2195921,1291457,904464,2021-12-05 23:30
10086,23,Meghalaya,1997486,1173288,824198,2021-12-05 23:30
10087,24,Mizoram,1301412,736910,564502,2021-12-05 23:30
10088,25,Nagaland,1297068,743385,553683,2021-12-05 23:30
10089,26,Odisha,44519434,28080922,16438512,2021-12-05 23:30
10090,27,Puducherry,1275197,782832,492365,2021-12-05 23:30
10091,28,Punjab,24560878,16654472,7906406,2021-12-05 23:30
10092,29,Rajasthan,70988235,43998601,26989634,2021-12-05 23:30
10093,30,Sikkim,995610,523497,472113,2021-12-05 23:30
10094,31,Tamil Nadu,73306467,46485652,26820815,2021-12-05 23:30
10095,32,Telangana,38916909,25510049,13406860,2021-12-05 23:30
10096,33,Tripura,4608016,2557912,2050104,2021-12-05 23:30
10097,34,Uttar Pradesh,167790317,114550351,53239966,2021-12-05 23:30
10098,35,Uttarakhand,12975153,7622998,5352155,2021-12-05 23:30
10099,36,West Bengal,94626346,63696145,30930201,2021-12-05 23:30
10100,37,Daman and Diu,497431,280402,217029,2021-12-05 23:30
10101,1,Andaman and Nicobar Islands,561619,297333,264286,2021-12-06 08:00
10102,2,Andhra Pradesh,61482587,35894766,25587821,2021-12-06 08:00
10103,3,Arunachal Pradesh,1415198,797018,618180,2021-12-06 08:00
10104,4,Assam,34188226,21487226,12701000,2021-12-06 08:00
10105,5,Bihar,85716703,55267494,30449209,2021-12-06 08:00
10106,6,Chandigarh,1597911,946805,651106,2021-12-06 08:00
10107,7,Chhattisgarh,26762014,16768542,9993472,2021-12-06 08:00
10108,8,Dadra and Nagar Haveli,627221,396371,230850,2021-12-06 08:00
10109,9,Delhi,23279034,14087352,9191682,2021-12-06 08:00
10110,10,Goa,2331885,1286729,1045156,2021-12-06 08:00
10111,11,Gujarat,82844070,46010925,36833145,2021-12-06 08:00
10112,12,Haryana,29289826,18740739,10549087,2021-12-06 08:00
10113,13,Himachal Pradesh,11229264,5838123,5391141,2021-12-06 08:00
10114,14,Jammu and Kashmir,16921457,9617709,7303748,2021-12-06 08:00
10115,15,Jharkhand,25226822,16872238,8354584,2021-12-06 08:00
10116,16,Karnataka,77197285,45640179,31557106,2021-12-06 08:00
10117,17,Kerala,43843472,25779384,18064088,2021-12-06 08:00
10118,18,Ladakh,384795,212359,172436,2021-12-06 08:00
10119,19,Lakshadweep,105511,55469,50042,2021-12-06 08:00
10120,20,Madhya Pradesh,90156055,51369376,38786679,2021-12-06 08:00
10121,21,Maharashtra,118450644,75892421,42558223,2021-12-06 08:00
10122,22,Manipur,2195933,1291460,904473,2021-12-06 08:00
10123,23,Meghalaya,1997488,1173290,824198,2021-12-06 08:00
10124,24,Mizoram,1301446,736943,564503,2021-12-06 08:00
10125,25,Nagaland,1297079,743394,553685,2021-12-06 08:00
10126,26,Odisha,44524289,28082691,16441598,2021-12-06 08:00
10127,27,Puducherry,1275218,782834,492384,2021-12-06 08:00
10128,28,Punjab,24562205,16654935,7907270,2021-12-06 08:00
10129,29,Rajasthan,70995172,44000174,26994998,2021-12-06 08:00
10130,30,Sikkim,995610,523497,472113,2021-12-06 08:00
10131,31,Tamil Nadu,73316862,46489289,26827573,2021-12-06 08:00
10132,32,Telangana,38920377,25512554,13407823,2021-12-06 08:00
10133,33,Tripura,4608104,2557912,2050192,2021-12-06 08:00
10134,34,Uttar Pradesh,167809898,114561296,53248602,2021-12-06 08:00
10135,35,Uttarakhand,12975396,7623032,5352364,2021-12-06 08:00
10136,36,West Bengal,94633150,63697739,30935411,2021-12-06 08:00
10137,37,Daman and Diu,497431,280402,217029,2021-12-06 08:00
